август: августа
авт: авт
авторство: авторства
аист: аист
аксенч: аксенчу
аксенчук: аксенчук аксенчука аксенчуку
алгоритм: алгоритм
александр: александра
алла: алле
алфавит: алфавиту
амсердать: амсердам
амстердам: амстердам
аниматограф: аниматограф
аниматор: аниматор аниматоры
анимация: анимации
апрель: апреля
артист: артист артисты
архангельск: архангельском
архивировать: архивировано
ассистент: ассистентом
афанасьев: афанасьев
баба: баба
баскаков: баскаков
беда: беда
бедлам: бедламе
бедность: бедности
безопасность: безопасности
белорусский: белорусском
берлин: берлина
берлинский: берлинской
библиографический: библиографических
библиотекарь: библиотекарем
биография: биография
благодаря: благодаря
больший: большая
бородин: бородин
брат: братья
брестский: брестской
бронзовый: бронзовый
буква: буквы
бывало: бывало
былина: былинах
быть: е
бюро: бюро
вайсфельд: вайсфельд
варшава: варшавы
варшавско: варшавско
ваш: ваше ваши
ведьма: ведьмы
век: века
великий: великой
венеция: венеции
версия: версия
верховный: верховного
взятие: взятие
видов: видова
викидать: викиданных
викимедиа: викимедиа
википедия: википедии википедия
винчи: винчи
витиеватый: витиевато витиеватых
вклад: вклад
владимир: владимир владимиром
внешний: внешние
внучек: внучек
воевать: воевал воевали
возраст: возраста
война: войне войну войны
войти: войти
волшебный: волшебного волшебные
ворона: ворона
время: время
всесоюзный: всесоюзное
второй: вторым
гарфа: гарф
гвоздь: гвоздь
георгий: георгий
германия: германией
гл: гл
глобус: глобуса
глухарь: глухарь
го: го
год: гг года годах годов году лет
голливуд: голливуд
голованов: голованов
голый: голая
гора: горе
горох: горохом
госпитализировать: госпитализирован
гоэлро: гоэлро
гражданство: гражданство
гриб: грибы
гриф: гриф
губерния: губерния
давыдов: давыдовым
данные: данных
дата: дата
дед: дед
дедушка: дедушка
действовать: действовать
декабрь: декабря
делать: делал
дело: дела дело
день: дней дня
детский: детских детском
деятель: деятели деятель
диплом: диплом
добавить: добавлена
добиться: добился
доброхотов: доброхотовым
доверительный: доверительные
должность: должность
дом: доме
дополнительный: дополнительные
дорога: дорогой
дорогой: дорогая
доступный: доступен
др: др
другой: другие других
дружеский: дружеских
дядя: дядя
евгений: евгения
единственный: единственное
екатеринбург: екатеринбург
елатомский: елатомский елатомском
ещё: ещё
её: её
желание: желанию
женатый: женат
живопись: живописи
жить: жил жили
заглавный: заглавная
зай: зай
занятие: занятий
запад: западе
запись: запись
зарегистрировать: зарегистрированный
заряжать: заряжающий
заслужить: заслуженные заслуженный
застать: застал
затем: затем
зачастую: зачастую
заявление: заявление
звание: звания
звезда: звёздам
здоровье: здоровье
знак: знак
золушка: золушка
ива: ива
иван: иван ивана
иванов: иванова
иванович: иванович
идея: идеи
избранный: избранные
изобразительный: изобразительного
илья: илья
именно: именно
имя: имя имён
инструмент: инструменты
интеллигентность: интеллигентность
интересно: интересно
интеррос: интеррос
инфобокс: инфобоксе
информация: информация
искусство: искусств искусства
использование: использования
использовать: использующие
истина: истина
история: история
источник: источник источниками источников
италия: италии
итальянский: итальянскую
июль: июля
кавалер: кавалеры
кадомский: кадомский
капкова: капкова
капок: капков
картотека: картотеки
карьера: карьера
каталог: каталогах
категория: категории
квартирка: квартирки
кинематограф: кинематографа
кинематографист: кинематографист кинематографистов
кино: кино
киножурнал: киножурнала
киноискусство: киноискусства
кинопоиск: кинопоиск
кинопроцесс: кинопроцесс
кинорежиссёр: кинорежиссёр
киностудия: киностудии
кладбище: кладбище
классический: классической
код: код
кодекс: кодекс
комма: комм
комментарий: комментарии
контактность: контактность
конфиденциальность: конфиденциальности
концепция: концепции
копейка: копейка
короткий: короткий
космос: космос
красный: красной
кроме: кроме
круг: круга
крумин: круминым
кук: куки
кукушка: кукушка
курс: курсах
л: л
ладушка: ладушки
лауреат: лауреат
легко: легко
леонард: леонарда
леонардо: леонардо
лесной: лесной
летие: летию
лисица: лисица
литература: литература
лицензия: лицензии
личность: личности
лозинский: лозинская
люблин: люблин
лёгкий: лёгким
м: м
май: мае мая
маленький: маленькой
мальчик: мальчик
марголин: марголина
март: марта
материал: материал
медаль: медали медаль медалью
международный: международных
менее: менее
место: место
мещеряк: мещеряков
мигунов: мигунова
милиционер: милиционер
миномёт: миномёта
мкф: мкф
мм: мм
многие: многие
многолетний: многолетние
многословный: многословен
мобильный: мобильная
могила: могиле могилы
молодильный: молодильные
молодёжь: молодёжью
мороз: мороз
москва: москва москве
московский: московские
мочь: мог могут
музыка: музыка
мультипликатор: мультипликатор мультипликатора мультипликаторами мультипликаторов мультипликатором
мультипликация: мультипликации мультипликацию мультипликация
мультфильм: мультфильмов мультфильмы
муромец: муромец
мы: нами
н: н
навигация: навигации навигация
награда: награда награды
наградить: награждённые
наградной: наградной
награждение: награждение
надолго: надолго
найти: нашёл
направление: направление
народ: народа народов
народный: народные народный народных
насмешка: насмешек
начало: начала
начать: начал
начинающий: начинающими
наш: наше наши
неаполь: неаполя
небесный: небесные
недоступный: недоступная
неизвестный: неизвестными
некоммерческий: некоммерческой
некрополист: некрополистов
немало: немало
неопр: неопр
неплохо: неплохо
нерабочий: нерабочими
николо: николо
нищенский: нищенской
новый: новые
ноябрь: ноября
ныне: ныне
область: область
обращение: обращения
обсуждение: обсуждение
обучаться: обучался
общество: общества общество
объяснять: объяснял
обыкновенный: обыкновенное
огонь: огнём
один: одного
окончить: окончил
октябрь: октябре октября
олег: олега
онлайн: онлайн
операция: операции операциях
описание: описание
опытный: опытного
организация: организации
орден: орден ордена
ореховый: ореховый
оригинал: оригинала
освобождение: освобождение
основать: основанном
остарков: остаркова
осторожно: осторожно
остроумный: остроумных
отвага: отвагу
ответный: ответной
ответственность: ответственности
отдельный: отдельных
отечественный: отечественного отечественной
отказ: отказ
открытый: открытых
отмечать: отмечали
относительно: относительно
отношение: отношения
отредактировать: отредактирована
ошибка: ошибке
памятный: памятная
память: память
парад: парада параде
параметр: параметрами
паром: паром
пенсия: пенсию
первый: первом
перейти: перейти
перерастать: перерастало
персоналия: персоналии
персональный: персональные
петух: петух
пехотинец: пехотинцы
печать: печати печать
пиджак: пиджак
плакат: плакаты
платформа: платформа
плита: плита
площадь: площади
плюс: плюс
победа: победу победы
поведение: поведения
подробный: подробнее
пожарный: пожарной
пожертвовать: пожертвовать
познанский: познанской
поиск: поиск поиску
показать: показать
политика: политика
полка: полка
полкан: полкан
получить: получить
поляна: поляны
полёт: полёте
помеха: помехи
помнить: помни
популяризация: популяризации
поросёнок: поросёнка
последний: последний
постановщик: постановщика
постоянно: постоянно
постоянный: постоянная
похоронить: похороненные
похоронный: похоронен
почёт: почёта
почётный: почётный
правило: правила правило
править: править
правка: правки
практикант: практикантами
предание: преданиях
предмет: предметом
представиться: представились
президиум: президиума
премия: премию премия
привезти: привёзший
пригласить: пригласив
приз: приз призы
призёр: призёр
приклеиться: приклеившееся
приключение: приключения
приложить: приложившего
примечание: примечания
причём: причём
проверить: проверьте
программа: программы
проделка: проделки
проект: проект проектах
прозвище: прозвища прозвище
произнести: произнёс
произношение: произношения
пролог: пролог
пропаганда: пропаганды
просмотр: просмотры
пространство: пространства
просяной: просяные
профессия: профессия
прутик: прутик
путанно: путанно
р: р
работать: работал работала работать
разбойник: разбойник
разговор: разговоров
разгромить: разгромленной
разночтение: разночтения
разный: разных
разобрать: разберём
разработчик: разработчики
рай: рай
район: район
райский: райское
ранить: ранен
реакция: реакции
ребёнок: детей детям
революция: революции
ред: ред
редкола: редкол
режиссёр: режиссёр режиссёра режиссёром режиссёры
режиссёрский: режиссёрские
рейс: рейс
ресурс: ресурсы
рискнуть: рискнуть
рисовать: рисованная рисованной рисующий
родиться: род родившиеся родился
родник: родник
рождение: рождении рождения
россия: россия
рсфср: рсфср
ру: ру
румынский: румынскую
русалочка: русалочка
русский: русский
русый: рус
рязанский: рязанская
сайт: сайты
сатирический: сатирического
сведение: сведения
свежий: свежие
свободный: свободной
свой: своего свои
связанный: связанные
связаться: свяжитесь
село: селе
семья: семья
семёнович: семёнович семёновича
сентябрь: сентября
сергей: сергей
сержант: сержантом
сила: сил
синеглазка: синеглазка
синематека: синематека
система: системе
сказание: сказаниях
сказка: сказка сказки
сказываться: сказывается
скачать: скачать
скончаться: скончался
скрытый: скрытые
слава: слава славы
сладкий: сладкий
слишком: слишком
словарь: словарь
словечко: словечко
слово: слова слово
служебный: служебные
случай: случай случаях
случайный: случайная
смерть: смерти
смотреть: см
соблюдать: соблюдай
собрать: соберём
собственный: собственному
событие: события
совершенно: совершенно
совет: совета
советский: советская советский советской
совместно: совместно
согласовать: согласованный
содержание: содержание
создавать: создавал
создать: создать
солнце: солнце
соловей: соловей
сообщество: сообщество
сообщить: сообщить
сост: сост
состояться: состоялось
сотрудник: сотрудников
сохранение: сохранением
социальный: социальные
союз: союза
союзмультфильм: союзмультфильм союзмультфильма
справка: справка
справочник: справочник
среди: среди
ссср: ссср
ссылка: ссылка ссылками ссылки
стажёр: стажёрами
становиться: становился
старание: стараниям
статистика: статистика
статья: статьи статья
степень: степени
страница: страница странице страницу страницы
стрелка: стрелок
стрелковый: стрелкового
стёпа: стёпа
супруг: супруга
существовать: существуют
сходиться: сходился
сценарист: сценарист
сюда: сюда
также: также
такой: таких
тамбовский: тамбовская
текст: текст
текущий: текущие
тематический: тематические
терние: тернии
технология: технологии
тип: тип
товарный: товарный
тринадцатый: тринадцатый
туржанский: туржанского
тяжёлый: тяжёлый
уезд: уезд уезде
узбекский: узбекскую
указ: указ
указание: указанием
указать: указан
улыбка: улыбка
умерший: умершие
усилие: усилиями
условие: условий условия
установить: установлена
утверждение: утверждениями
утиль: утиль
уход: ухода
участвовать: участвовал
участие: участие
участник: участники
учётный: учётную
февраль: февраля
фестиваль: фестивалей
фильм: фильмов фильмы
фильмография: фильмография
фитиль: фитиль
фокус: фокус
фонд: фонд
форум: форум
фото: фото
фр: фр
фронт: фронте
хап: хап
хлеб: хлебе
хотеть: хочет
художник: художник художника художникам художники художников художником
цех: цехе
цитировать: цитировать
частность: частности
часы: часы
человек: людьми человек человека
чемпион: чемпион
чик: чик
читать: читать
член: член члены
чудо: чудо
шаблон: шаблона
шавка: шавка
шалаш: шалаше
шварцман: шварцман
шутка: шуток
эврика: эврика
экз: экз
экранизировать: экранизировал
экспорт: экспорт
электрификация: электрификация
элемент: элемент
энциклопедический: энциклопедический
энциклопедия: энциклопедии энциклопедия
эстафета: эстафета
эстрада: эстраде
это: это
этот: эта
ю: ю
юбилей: юбилее юбилею
юношеский: юношеских
юношество: юношества
юткевич: юткевич юткевича
яблоко: яблоки
язык: языках
январь: январе
