авторство: авторства
алфавит: алфавиту
альбин: альбин
амелин: амелин
антифашистский: антифашистской
архитектура: архитектура
б: б
барревика: барревик
библиографический: библиографических
больший: большая
борьба: борьбы
быть: е
вд: вд
век: века
версия: версия
викидать: викиданных
викимедиа: викимедиа
википедия: википедии википедия
викисклад: викисклад викискладе
вклад: вклад
внешний: внешние
возглавлять: возглавлял
войти: войти
выставка: выставка
генерал: генерала
геоцепочка: геоцепочками
гл: гл
год: года годах году
государственный: государственном государственный
графика: графика
дата: дат дата
датский: датская
два: две
действовать: действовать
декоративный: декоративное
демократический: демократического
деятель: деятели
деятельность: деятельности
доп: доп
дополнительный: дополнительные
доступный: доступен
другой: других
ещё: ещё
женщина: женщины
живопись: живопись
жить: жил
заглавный: заглавная
западноевропейский: западноевропейская
западный: западного
запись: запись
зарегистрировать: зарегистрированный
затронуть: затронул
заявление: заявление
знак: знак
избранный: избранные
изд: изд
изобразительный: изобразительного
иллинойс: иллинойс
иметься: имеются
имя: имя имён
инструмент: инструменты
иогансон: иогансон
искусство: искусства искусстве искусство
использование: использования
испр: испр
история: история
источник: источник источниками
карточка: карточки
каталог: каталог каталогах
категория: категории
код: код
кодекс: кодекс
констфак: констфак
конфиденциальность: конфиденциальности
короткий: короткий
краткий: краткая
крыло: крыла
кук: куки
л: л
литература: литература
лицензия: лицензии
м: м
материал: материал
медиафайл: медиафайлы
место: место
мир: мира
мобильный: мобильная
мочь: могут
музей: музее
мы: нами
навигация: навигации навигация
народ: народа народов
независимый: независимых
некоммерческий: некоммерческой
немой: нем
неоднозначный: неоднозначными
нидерл: нидерл
новый: нового новые
норвежский: норвежская
ноябрь: ноября
обращаться: обращался
обсуждение: обсуждение
общество: общество
объединение: объединения
окно: окна
описание: описание
организация: организации
основатель: основатель
ответственность: ответственности
отдельный: отдельных
отказ: отказ
отредактировать: отредактирована
ошибка: ошибке
параметр: параметров
первый: первым
перейти: перейти
персоналия: персоналии
персональный: персональная персональные
печать: печати печать
поведение: поведения
подробный: подробнее
пожертвовать: пожертвовать
поиск: поиск поиску
политика: политика
получить: получить
последний: последний
постоянный: постоянная
править: править
правка: правки
преамбула: преамбуле
представитель: представителем
представиться: представились
примечание: примечания
проект: проектах
просмотр: просмотры
пространство: пространства
р: р
работа: работы
разработчик: разработчики
ред: ред
ресурс: ресурсы
родиться: род родившиеся
рождение: рождении рождения
русский: русский
сайт: сайты
сведение: сведения
свежий: свежие
свободный: свободной
свой: своем
связанный: связанные
связаться: свяжитесь
система: системе
скачать: скачать
скрытый: скрытые
скульптура: скульптура
словарь: словари
служебный: служебные
случай: случаях
случайный: случайная
смерть: смерти
смотреть: см
событие: события
советский: советская
содержание: содержание
создать: создать
сообщество: сообщество
сообщить: сообщить
состояться: состоялась
сохранение: сохранением
социально: социально
справка: справка
ссылка: ссылка ссылки
статистика: статистика
статья: статьи статья
стокгольм: стокгольме
страна: стран страна
страница: страница странице страницу страницы
сша: сша
сюда: сюда
так: т
творчество: творчестве
текст: текст
текущий: текущие
тема: темам тему
тематический: тематические
технический: техническом
товарный: товарный
труд: труда
указание: указанием
умерший: умершие
условие: условий условия
участие: участие
училище: училище
учиться: учился
учёба: учёба
учётный: учётную
фамилия: фамилией
февраль: февраля
фонд: фонд
форум: форум
франко: франко
франция: франции
художественный: художественная
художник: художник художника художники художников
цивилизация: цивилизация
цитировать: цитировать
человек: людях
чикаго: чикаго
читать: читать
швед: швед
шведский: шведский шведского шведском
швеция: швеции швеция
экспорт: экспорт
экспрессионизм: экспрессионизма
элемент: элемент
энциклопедия: энциклопедии энциклопедия
эрмитаж: эрмитаж эрмитаже
этот: эта
являться: является
язык: языках
январь: января
