авторство: авторства
александр: александр александра
алтайский: алтайская алтайский алтайского
алфавит: алфавиту
андрусенко: андрусенко
апрель: апреля
архивный: архивная
ассоциация: ассоциации
балкон: балкон
барнаул: барнаул барнауле
биография: биографии биография
борисович: борисович
век: века
вернуться: вернулся
версия: версия
викидать: викиданных
викимедиа: викимедиа
википедия: википедии википедия
вклад: вклад
внимание: внимание
войти: войти
впоследствии: впоследствии
время: времени время
врубель: врубеля
выставка: выставка выставке выставки
выставочный: выставочный
год: году
городской: городской
государственный: государственном государственный
далее: д
дата: дата
действовать: действовать
декабрь: декабря
детский: детской
детство: детства
деятель: деятели
дипломант: дипломант
добавить: добавить
домой: домой
дополнительный: дополнительные
дорога: дорога
доступный: доступен
дочь: дочь
драматический: драматический
другой: других
ещё: ещё
живопись: живопись
жить: жил
заглавный: заглавная
зал: зал
заниматься: заниматься
занятие: занятий
запись: запись
зарегистрировать: зарегистрированный
заявление: заявление
знак: знак
избранный: избранные
известный: известный
изображение: изображений
изобразительный: изобразительного изобразительных
имя: имени имён
инструмент: инструменты
интересный: интересная
искусство: искусств искусства искусство
использование: использования
история: история
источник: источник
картина: картины
категория: категории
каширка: каширке
код: код
кодекс: кодекс
коллекция: коллекциях
коми: коми
комсомольский: комсомольская
конфиденциальность: конфиденциальности
копия: копия
короткий: короткий
край: край края
кук: куки
лауреат: лауреат
либер: либеров
лицензия: лицензии
м: м
март: марта
материал: материал
международный: международной
мера: меру
местный: местной
место: место
мир: мира
мобильный: мобильная
морозов: морозов
москва: москва москве
московский: московский
мочь: могут
музей: музее
мы: нами
навигация: навигации навигация
наглый: наглая
народ: народов
небо: неба
некоммерческий: некоммерческой
некоторый: некоторое
новоалтайский: новоалтайское
новосибирский: новосибирской
новый: новые
облако: облака
областной: областном
обратить: обратил
обсуждение: обсуждение
огонь: огни
окончить: окончил
омск: омск омске
омский: омском
описание: описание
организация: организации
ответственность: ответственности
отдельный: отдельных
отказ: отказ
открыться: открылась
отредактировать: отредактирована
оценить: оценил
очень: очень
ошибка: ошибке
перейти: перейти
персоналия: персоналии
персональный: персональные
печать: печати печать
поведение: поведения
подробный: подробнее
пожертвовать: пожертвовать
поиск: поиск поиску
политика: политика
получить: получить
последний: последний
поспелиха: поспелиха поспелиху
поспелихинский: поспелихинский поспелихинском
постоянный: постоянная
правда: правда
править: править
правка: правки
представиться: представились
премия: премии
преподавать: преподаёт
признание: признание
продолжать: продолжает
проект: проектах
просмотр: просмотры
пространство: пространства пространстве
профессор: профессор
работа: работы
работать: работал
разработчик: разработчики
район: район районе
ребёнок: детей
республика: республики
республиканский: республиканском
рисование: рисования
рисовать: рисовать
род: родом
родина: родина
родиться: род родившиеся родился
родный: родную
рождение: рождения
романс: романс
российский: российский
россия: россии
рсфср: рсфср
русский: русский
сведение: сведения
свежий: свежие
свободный: свободной
связанный: связанные
связаться: свяжитесь
сделать: сделанная
село: селе
сибирский: сибирские
сибирь: сибирь
система: системе
скачать: скачать
скрытый: скрытые
служебный: служебные
случай: случаях
случайный: случайная
смелый: смелая
смотреть: см
событие: события
современник: современников
содержание: содержание
создать: создать
сообщество: сообщество
сообщить: сообщить
сохранение: сохранением
союз: союза
способность: способности
справка: справка
ссср: ссср
ссылка: ссылка ссылки
статистика: статистика
статья: статьи статья
страна: стран
страница: страница странице страницу страницы
сюда: сюда
так: т
также: также
талантливый: талантливая
творчество: творчеством
театр: театр
текст: текст
текущий: текущие
темпераментный: темпераментная
тип: тип
тишина: тишина
товарный: товарный
указание: указанием
уровень: уровне
условие: условий условия
участие: участие
училище: училище
учитель: учитель
учить: учить
учёба: учёба
учётный: учётную
фамилия: фамилией
февраль: февраля
фонд: фонд
форум: форум
х: х
храниться: хранятся
художественный: художественное художественном художественные художественным
художник: художник художника художники художников
цдх: цдх
центр: центр
цитировать: цитировать
частный: частных
человек: людях человек
читать: читать
член: член
школа: школе
экспорт: экспорт
элемент: элемент
энциклопедия: энциклопедии
этот: эта
язык: языках
яркий: яркая
