авторство: авторства
адский: адский
актёр: актёр актёра актёры
акула: акула
алфавит: алфавиту
альмирион: альмирион
анда: анда
аплодировать: аплодируют
ассоциированный: ассоциированный
бег: бег
биография: биографии биография
боевик: боевик
век: века
версия: версия
викидать: викиданных
викимедиа: викимедиа
википедия: википедии википедия
вклад: вклад
внешний: внешние
войти: войти
время: время
год: года году лет
гражданство: гражданство
дата: дата
де: де
дебютировать: дебютировал
действовать: действовать
демон: демонов
деятель: деятели
джонс: джонс
дополнительный: дополнительные
доступный: доступен
досье: досье
другой: других
дурнушка: дурнушка
ещё: ещё
женщина: женщина
жестокий: жестокий
жизнь: жизни
заглавный: заглавная
занятие: занятий
запись: запись
зарегистрировать: зарегистрированный
заявление: заявление
зверь: зверя
знак: знак
избранный: избранные
изнасилование: изнасилование
изображение: изображений
изобразительный: изобразительного
имя: имя имён
инструмент: инструменты
искусство: искусства
исп: исп
использование: использования
истинный: истинная
история: история
источник: источник
кандидатка: кандидатка
карьера: карьера
категория: категории
качество: качестве
кинематограф: кинематографе
кино: кино
киноактёр: киноактёр
кинопоиск: кинопоиск
кинорежиссёр: кинорежиссёр
код: код
кодекс: кодекс
конструктор: конструктор
конфиденциальность: конфиденциальности
короткий: короткий
который: которому которых
криминал: криминал
кровь: крови
кук: куки
лицензия: лицензии
любовь: любовь
мальчик: мальчик
материал: материал
мексика: мексика мексики
мексиканский: мексиканский мексиканском
мелодрама: мелодрама
место: место
мехико: мехико
мобильный: мобильная
монтажёр: монтажёр монтажёра монтажёры
мочь: могут
мы: нами
н: н
навигация: навигации навигация
написать: написал
направление: направление
наркополиция: наркополиция
натурщица: натурщицы
некоммерческий: некоммерческой
новый: новые
нотариус: нотариус
ночь: ночь
обсуждение: обсуждение
огонь: огонь
описание: описание
организация: организации
ответственность: ответственности
отдельный: отдельных
отказ: отказ
отметить: отмеченное
отредактировать: отредактирована
охотник: охотник
ошибка: ошибке
пантера: пантера
перейти: перейти
персоналия: персоналии
персональный: персональные
печать: печати печать
поведение: поведения
подробный: подробная подробнее
пожертвовать: пожертвовать
поиск: поиск поиску
поймать: пойманный
политика: политика
получить: получить
пора: пор
последний: последний последняя
поставить: поставил
постоянный: постоянная
править: править
правка: правки
представиться: представились
прекрасный: прекрасная
принять: принял
прицел: прицелом
продюсер: продюсер продюсера продюсеры
проект: проектах
просмотр: просмотры
пространство: пространства
против: против
профессия: профессия
работа: работах
разработчик: разработчики
реальный: реальной
режиссёр: режиссёр режиссёра режиссёры
ресурс: ресурсы
рикардо: рикардо
родиться: род родившиеся родился
рождение: рождении рождения
роль: роли
русский: русский
сайт: сайте сайты
самый: самая
сведение: сведения
свежий: свежие
свободный: свободной
связанный: связанные
связаться: свяжитесь
секрет: секрет
семеро: семеро
серрано: серрано
сеть: сетях
система: системе
скачать: скачать
скрытый: скрытые
служебный: служебные
случай: случаи случаях
случайный: случайная
смерть: смерти смерть
смотреть: см
событие: события
современник: современников
содержание: содержание
создать: создать
сообщество: сообщество
сообщить: сообщить
сохранение: сохранением
социальный: социальных
справка: справка
спродюсировать: спродюсировал
ссылка: ссылка ссылки
статистика: статистика
статья: статьи статья
стол: стол
страница: страница странице страницу страницы
сценарий: сценарии
сценарист: сценарист сценариста сценаристы
сыграть: сыграл
сюда: сюда
твиттер: твиттер
текст: текст
текущий: текущие
телесериал: телесериал телесериалам телесериалах телесериалы
тематический: тематические
тип: тип
тихуан: тихуана
товарный: товарный
тот: тех
триллер: триллер
трон: трон
ужас: ужасов
указание: указанием
уриб: урибе
условие: условий условия
утечка: утечка
участие: участие
учётный: учётную
февраль: февраля
фильм: фильм фильма фильмам фильмов фильмы
фильмография: фильмографией фильмография
фонд: фонд
форум: форум
хильберто: хильберто
художник: художник художника художники
цитировать: цитировать
человек: человек
читать: читать
шакал: шакала
экспорт: экспорт
элемент: элемент
энциклопедия: энциклопедии
этот: эта
язык: языках
январь: января
