август: августа
авторитетный: авторитетные
авторство: авторства
алфавит: алфавиту
альби: альби
альбицкий: альбицкий
анфас: анфас
архивировать: архивировано
беларускать: беларуская
беларусь: беларуси беларусь
беларусьфильм: беларусьфильм
белорусский: белорусский белорусской
белый: белое
бессменно: бессменно
биография: биография
богородский: богородского
боль: боль
бронзовый: бронзовая
бсср: бсср
вгик: вгик вгика
век: века
версия: версия
весь: всей
взять: возьму
вид: виде
викидать: викиданных
викимедиа: викимедиа
википедия: википедии википедия
вклад: вклад
влович: влович
внешний: внешние
возвращение: возвращения
войти: войти
волчий: волчья
впереди: впереди
вулкан: вулканом
выпускник: выпускники
выставка: выставках
год: года годах году лет
гомункулус: гомункулус
государственный: государственная государственной
дата: дата
двое: двое
действовать: действовать
декабрь: декабря
декорация: декораций декорация
дело: дело
день: день
деятель: деятели деятель
деятельность: деятельности
дипломный: дипломная
добавить: добавив
дождь: дожди
должный: должна
дополнительный: дополнительные
доступный: доступен
др: др
другой: других
егорьевск: егорьевск егорьевске
ехать: едет
ещё: ещё
жанр: жанр
живой: живым
жизнь: жизни
заглавный: заглавная
занятие: занятий
запись: запись
запомнить: запомним
зарегистрировать: зарегистрированный
заслужить: заслуженные заслуженный
затем: затем
заявление: заявление
звание: звания
знак: знак
иван: иван
идти: иду
избранный: избранные
изобразительный: изобразительного
империя: империи
имя: имён
иначе: иначе
инструмент: инструменты
информация: информация
искать: искать
искусство: искусств искусства
исполняться: исполняется
использование: использования
история: история
источник: источник источники источников
категория: категории
киевский: киевский
кино: кино
кинопоиск: кинопоиск
киностудия: киностудии
кирилл: кирилла
клуб: клуб
код: код
кодекс: кодекс
коллекционер: коллекционеров
конец: конца
конфиденциальность: конфиденциальности
короткий: короткий
кортик: кортик
крутой: крутой
крушение: крушение
кук: куки
лауреат: лауреат лауреаты
легенда: легенды
лицензия: лицензии
материал: материал
международный: международных
место: место
мефодий: мефодия
минский: минский
мобильный: мобильная
московский: московская
мочь: могут можете
мужчина: мужчин
мы: нами
мёд: мёд
навигация: навигации навигация
награда: награды
настоящий: настоящих
научиться: научись
некоммерческий: некоммерческой
неопр: неопр
новый: новые
ночь: ночь
область: область
обращение: обращения
обсуждение: обсуждение
обучение: обучение
один: одна
озеро: озеро
окончить: окончил
описание: описание
организация: организации
оса: осы
остров: острове
ответственность: ответственности
отдельный: отдельных
отказ: отказ
отредактировать: отредактирована отредактировать
ошибка: ошибке
па: па
павлович: павлович
перейти: перейти
персоналия: персоналии
персональный: персональные
печать: печати печать
пименов: пименова
письмо: письма
поведение: поведения
поворот: поворот
подробный: подробнее
пожертвовать: пожертвовать
поиск: поиск поиску
политика: политика
получить: получить
последний: последний
постановщик: постановщик
постоянный: постоянная
править: править
правка: правки
прага: прагу
представить: представленная
представиться: представились
премия: премии премия
приказ: приказ
примечание: примечания
проверять: проверяема
продолжение: продолжение
проект: проектах
просмотр: просмотры
пространство: пространства
профиль: профиль
птица: птица
пущик: пущик
работа: работа
работать: работал
разный: разного
разработчик: разработчики
раскадровка: раскадровок
реализм: реализм
результат: результатом
рекомендация: рекомендации
республика: республика
республиканский: республиканских
ресурс: ресурсы
рий: рий
родиться: род родившиеся
рождение: рождения
рсфср: рсфср
рудобельский: рудобельская
руководство: руководством
русский: русский
рязанский: рязанском
сайт: сайты
сведение: сведения
свежий: свежие
свободный: свободной
связанный: связанные
связаться: свяжитесь
система: системе
скачать: скачать
скрытый: скрытые
слеза: слёз
словарь: словари
служебный: служебные
случай: случаях
случайный: случайная
смерть: смерти
смотреть: см
сноска: сносок
событие: события
советский: советский
содержание: содержание
создать: создать
сообщество: сообщество
сообщить: сообщить
сохранение: сохранением
социалистический: социалистический
соцреализм: соцреализм
справка: справка
сср: сср
ссср: ссср
ссылка: ссылка ссылки ссылок
статистика: статистика
стать: стала
статья: статье статьи статью статья
стая: стая
стиль: стиль
страна: страна
страница: страница странице страницу страницы
сюда: сюда
танцевать: танцевать
твой: твою
текст: текст
текущий: текущие
телевизионный: телевизионный
тематический: тематические
территория: территории
тип: тип
товарный: товарный
удалить: удалена
указание: указанием
умерший: умершие
уровень: уровня
условие: условий условия
участвовать: участвовал
участие: участие
училище: училище
учиться: учился
учёба: учёба учёбы
учётный: учётную
ф: ф
факультет: факультета факультете
фамилия: фамилией
февраль: февраля
фильм: фильму
фильмография: фильмография
фонд: фонд
форум: форум
хватать: хватает
художественный: художественного художественном
художник: художник художники
цитировать: цитировать
цкий: цкий
человек: людях человек
читать: читать
экспорт: экспорт
элемент: элемент
энциклопедия: энциклопедии
эскиз: эскизов
этот: эта
ю: ю
юрий: юрий
язык: языках
январь: января
