авторство: авторства
агент: агента
академия: академии академия
актёр: актёров
алфавит: алфавиту
анкер: анкер анкера
анна: анна
анне: анне
апрель: апреля
банкнот: банкноте
берег: берегу
библиографический: библиографических
биография: биография
больной: больная
больший: большая больших
борнхольм: борнхольм борнхольме
борьба: борьба
брённум: брённум
быт: быта
вд: вд
век: века
версия: версия
викидать: викиданных
викимедиа: викимедиа
википедия: википедии википедия
викисклад: викисклад викискладе
вклад: вклад
внешний: внешние
внимание: вниманием
войти: войти
время: время
выпускник: выпускники
высокий: высоких
галерея: галерея
генеалогия: генеалогия
героизм: героизма
год: годах году лет
дания: дания
дата: дат дата
датский: датская датский датских датского датской
де: де
дебютировать: дебютировал
девушка: девушка
действительность: действительности
действовать: действовать
день: день
деревня: деревне
деятель: деятели
деятельность: деятельности
дом: дома
дополнительный: дополнительные
доступный: доступен
драматический: драматическим
другой: других
дюна: дюны
ещё: ещё
жанр: жанр
жена: жена
жениться: женился
жизнь: жизни
житель: жителей
завтрак: завтрак завтраком
заглавный: заглавная
заниматься: занимался
запись: запись
заполнить: заполнить
зарегистрировать: зарегистрированный
заявление: заявление
знак: знак
знаменитый: знаменитый
избранный: избранные
известный: известен известнейшие
изображение: изображениями
изобразительный: изобразительного
изобразить: изображены
изящный: изящных
ик: ик
импрессионизм: импрессионизма
имя: имён
инструмент: инструменты
искусство: искусств искусства
использование: использования
исторический: исторических
история: история
источник: источник источниками
итальянский: итальянская
июнь: июня
картина: картин картинами картинах картины
каталог: каталогах
категория: категории
классический: классические
код: код
кодекс: кодекс
колония: колонии
колорит: колорита
комбинировать: комбинирует
композиционный: композиционные
конфиденциальность: конфиденциальности
копенгаген: копенгагене
королевский: королевская королевской
короткий: короткий
крещение: крещение
кристоффер: кристоффера
кройер: кройер кройера
крона: крон
кук: куки
летний: летний
лицензия: лицензии
лодка: лодки
мастерская: мастерской
материал: материал
медаль: медаль медалью
медиафайл: медиафайлы
местный: местных
место: место
микаэль: микаэль микаэля
мимо: мимо
многий: многих
многофигурный: многофигурных
множество: множество
мобильный: мобильная
монументальный: монументальные
море: море
мотив: мотивов
мочь: могут
мунк: мунк
мы: нами
мыс: мыс
навигация: навигации навигация
награда: награды
наградить: награждённые
национальный: национального
начинающий: начинающей
неизвестный: неизвестными
некоммерческий: некоммерческой
некрополистик: некрополистика
новый: новые
норвежский: норвежская
нська: нська
обойти: обойдёт
образ: образы
обсуждение: обсуждение
обучение: обучение
обходить: обходил
общество: общества
один: одним
около: ок
опасный: опасным
описание: описание описания
организация: организации
основатель: основателей
основать: основанные
основный: основных
остров: острове
ответственность: ответственности
отдельный: отдельных
отказ: отказ
отредактировать: отредактирована
ошибка: ошибке
п: п
параметр: параметрами
париж: париж
перейти: перейти
персоналия: персоналии
персональный: персональные
печать: печати печать
писать: писал
пляж: пляже
поведение: поведения
подробный: подробнее
поездка: поездку
пожертвовать: пожертвовать
поиск: поиск поиску
политика: политика
получить: получить
портрет: портрет портретами
посвятить: посвящены посвящённые
последний: последний
постоянный: постоянная
поэтичность: поэтичности
править: править
правка: правки
предпринять: предпринял
представитель: представитель
представиться: представились
представлять: представляют
привносить: привнося
приехать: приехал
примечание: примечания
принцип: принципы
присоединиться: присоединился
продолжить: продолжил
проект: проектах
проносить: проносят
просмотр: просмотры
пространство: пространства
проходить: проходит
пювить: пюви
работа: работ работы
раздел: раздел
разработчик: разработчики
реализм: реализмом
реалистический: реалистические
ресурс: ресурсы
родиться: род родившиеся родился
рождение: рождения
романтик: романтики
русский: русский
рутскер: рутскер
рыбак: рыбак рыбака рыбаки рыбаков
рыбацкий: рыбацкой
сайт: сайты
сведение: сведения
свежий: свежие
свободный: свободной
свойство: свойство
связанный: связанные
связаться: свяжитесь
себя: собой
сельский: сельских сельского
сентябрь: сентября
система: системе
скаген: скаген скагена скагене
скагенский: скагенские
скачать: скачать
скрытый: скрытые
словарь: словари
слой: слоёв
служебный: служебные
случай: случаях
случайный: случайная
смерть: смерти
смотреть: см
событие: события
содержание: содержание
создать: создать
сообщество: сообщество
сообщить: сообщить
сохранение: сохранением
спасательный: спасательную
справка: справка
сразу: сразу
српски: српски
ссылка: ссылка ссылками ссылки
статистика: статистика
статья: статьи статья
стихия: стихией
страна: страна
страница: страница странице страницу страницы
супруг: супруга
сцена: сцены
сын: сын
сюда: сюда
творчество: творчества
текст: текст
текущий: текущие
тематика: тематике
тематический: тематические
товарный: товарный
торвальдсти: торвальдсена
торговый: торгового
указание: указанием
укра: укра
улов: улова
умерший: умершие
уроженка: уроженке
условие: условий условия
утонуть: утонувший
участие: участие
учиться: учился
учёба: учёба
учётный: учётную
фонд: фонд
формат: формату
формироваться: формировавшейся
форум: форум
фотопортрет: фотопортрет
фру: фру
художество: художеств
художник: художник художники художников
художница: художнице
цитировать: цитировать
человек: люди человека
четыре: четыре
читать: читать
шаблон: шаблона
шаванна: шаванна
шлюпка: шлюпку
экерсберг: экерсберга
эккерсберг: эккерсберга
экспорт: экспорт
элемент: элемент элементы
элизабет: элизабет
эллен: эллен
энциклопедия: энциклопедии
эпизод: эпизодам
этот: эта
ютландский: ютландских
язык: языках
ян: яна
