авторство: авторства
академия: академии
алексич: алексича
алфавит: алфавиту
альбом: альбомы
амур: амур
амурский: амурской
ардимас: ардимасов
аспирантура: аспирантуре
база: базе
бикинский: бикинский бикинского бикинском
биография: биографии биография
быть: е
век: века
версия: версия
викидать: викиданных
викимедиа: викимедиа
википедия: википедии википедия
вклад: вклад
возвращаться: возвращаться
войти: войти
вступительный: вступительных
вуз: вуза
выдающийся: выдающихся
выпускник: выпускники
год: года году годы лет
графика: графика
графический: графический
гуманитарный: гуманитарных
дальнейший: дальнейшем
дата: дата
дворец: дворце
действительный: действительный
действовать: действовать
декан: декан
деятель: деятели
добавить: добавить
документ: документов документы
домой: домой
дополнительный: дополнительные
доступный: доступен
другой: других
ещё: ещё
жибиновый: жибинова
живопись: живопись
жизнь: жизни
жить: живёт жили
заглавный: заглавная
заниматься: занимался заниматься
занятие: занятий
запись: запись
зарегистрировать: зарегистрированный
заслужить: заслуженные заслуженный
заявление: заявление
звание: звания
знак: знак
иванович: иванович
избранный: избранные
изображение: изображений
изобразительный: изобразительного
изостудия: изостудии
имя: имени имён
институт: институт институте
инструмент: инструменты
иркутский: иркутского иркутское
искусство: искусства
использование: использования
история: история
источник: источник
июль: июля
казак: казаков
категория: категории
каф: каф
кибрик: кибрика
класс: классов
км: км
коган: когана
код: код
кодекс: кодекс
конфиденциальность: конфиденциальности
короткий: короткий
край: край края
краснознамённый: краснознаменной
кук: куки
курс: курса
лермонтовка: лермонтовка лермонтовке
лицензия: лицензии
м: м
максимов: максимова
март: марта
мастерская: мастерской
материал: материал
мать: мать
мгха: мгхи
место: место
мобильный: мобильная
моосха: моосх
москва: москве москву
московский: московский московского московскую
мочь: могут
мсхш: мсхш
мы: нами
навигация: навигации навигация
награда: награды
народный: народные народный
наука: наук
некоммерческий: некоммерческой
неопр: неопр
несмотря: несмотря
новый: новые
обращение: обращения
обсуждение: обсуждение
обучение: обучение
окончание: окончании окончания
окончить: окончил
олег: олег
описание: описание
организация: организации
оригинал: оригиналы
остаться: остался
ответственность: ответственности
отдельный: отдельных
отец: отец
отказ: отказ
отправить: отправил
отредактировать: отредактирована
очарование: очарование
очень: очень
ошибка: ошибке
п: п
педагог: педагогом
первый: первым
переехать: переехала
перейти: перейти
персоналия: персоналии
персональный: персональные
печать: печати печать
пионер: пионеров
поведение: поведения
подмосковье: подмосковье
подольск: подольске
подробный: подробнее
поезд: поезде
поехать: поехал
пожертвовать: пожертвовать
поздний: позднее
поиск: поиск поиску
политика: политика
полный: полную
получить: получить
последний: последний
постоянный: постоянная
поступить: поступил
править: править
правка: правки
правление: правления
представиться: представились
преподаватель: преподавателей преподаватели преподавателя
прийтись: пришлось
продолжить: продолжил
проект: проектах
происходить: происходил
пропасть: пропали
проректор: проректор
просмотр: просмотры
пространство: пространства
пурот: пуртов
работа: работами
работать: работает
разработчик: разработчики
район: район района районе
рано: рано
расположить: расположенной
ребёнок: детей
рисование: рисованием
рисунок: рисунки
родиться: род родившиеся родилась родился
рождение: рождения
российский: российский российской
россия: россии россия
рсфср: рсфср
руководство: руководством
русский: русский
савин: савиных
сведение: сведения
свежий: свежие
свободный: свободной
свой: своими
связанный: связанные
связаться: свяжитесь
сдача: сдачу
семья: семье семья
серьёзно: серьёзно
система: системе
скачать: скачать
скрытый: скрытые
следом: следом
служебный: служебные
случай: случаях
случайный: случайная
смотреть: см
событие: события
совет: совету
советский: советский
современник: современников
содержание: содержание
создать: создать
сообщество: сообщество
сообщить: сообщить
сохранение: сохранением
союз: союза
справка: справка
средний: средней
ссср: ссср
ссылка: ссылка ссылки ссылок
ставка: ставку
станковый: станковой
старший: старший
статистика: статистика
стать: стал
статья: статьи статья
страна: страна
страница: страница странице страницу страницы
суворов: суворова
суриков: сурикова
сюда: сюда
тв: тв
текст: текст
текущий: текущие
терский: терских
тип: тип
товарный: товарный
увлечься: увлекся
указание: указанием
условие: условий условия
успешный: успешную
участие: участие
училище: училища училище
учиться: учился
учёба: учёба
учётный: учётную
факультет: факультет факультета
федерация: федерации
фио: фио
флотилия: флотилии
фонд: фонд
форум: форум
хабаровск: хабаровск хабаровска хабаровске
хабаровский: хабаровский хабаровского
художественный: художественного художественное художественную художественный
художник: художник художники художников
цитировать: цитировать
ч: ч
человек: человек
читать: читать
член: член члены
шаблон: шаблоном
школа: школе школу школы
экзамен: экзаменов
экспорт: экспорт
элемент: элемент
энциклопедия: энциклопедии
этот: эта
язык: языках
