август: августа
автор: автор авторы
авторство: авторства
академия: академии академия
алфавит: алфавиту
амашук: амашуке
амашукель: амашукели
апрель: апреля
архивировать: архивировано
архитектура: архитектуры
аспирантура: аспирантуре
ах: ах
барельеф: барельефов
библиографический: библиографических
биографический: биографический
биография: биография
болгария: болгарии
больший: большая
большой: большой
быть: е
важа: важа
вахтанг: вахтангу
век: века
версия: версия
викидать: викиданных
викимедиа: викимедиа
википедия: википедии википедия
викисклад: викисклад викискладе
вклад: вклад
внешний: внешние
войти: войти
волшебный: волшебные
выпускник: выпускники
г: г
генеалогия: генеалогия
герой: героям
гл: гл
год: года годах году
горгасали: горгасали
гореть: гори
государственный: государственная государственной
гражданин: граждане гражданин
гражданство: гражданство
груз: груз
грузинский: грузинская грузинский грузинской
грузия: грузии грузия
давидович: давидович
давить: дави
дата: дата
действовать: действовать
деятель: деятели
деятельность: деятельности
джа: джа
дидубийский: дидубийском
дович: дович
дополнительный: дополнительные
доступный: доступен
другой: другим других
дружба: дружбы
ежегодник: ежегодник
ещё: ещё
жанр: жанр
жить: жил
заглавный: заглавная
запись: запись
зарегистрировать: зарегистрированный
заслужить: заслуженные заслуженный
заявление: заявление
звание: звания
знак: знак
знамя: знамени
зсфср: зсфср
избранный: избранные
изд: изд
издательство: издательств
изобразительный: изобразительного
иллюстратор: иллюстраторы
иллюстрировать: иллюстрировал
имя: имени имя имён
инструмент: инструменты
искусство: искусства
использование: использования
использовать: использующие
история: история
источник: источник источникам источниками
июнь: июня
кавалер: кавалеры
канделаки: канделаки
картина: картин
каталог: каталогах
категория: категории
книга: книги
код: код
кодекс: кодекс
конфиденциальность: конфиденциальности
короткий: короткий
корреспондент: корреспондент корреспонденты
красный: красного
кук: куки
лауреат: лауреат лауреаты
лес: леса
лита: лит
литература: литературы
литовский: литовская
лицензия: лицензии
м: м
март: марта
материал: материал
мать: мать
медальон: медальонов
медиафайл: медиафайлы
мемориал: мемориал мемориала мемориалов
место: место
метро: метро
мобильный: мобильная
монумент: монумент монумента
монументалист: монументалисты
моряк: морякам
мочь: могут
мцхетский: мцхетская
мы: нами
н: н
навигация: навигации навигация
награда: награды
накадуля: накадули
народ: народов
народный: народной народные народный
наука: наук
некоммерческий: некоммерческой
некрополистик: некрополистика
неопр: неопр
нибелунг: нибелунгах
новый: новые
нська: нська
ныне: ныне
область: области
обращение: обращения
обсуждение: обсуждение
обучение: обучение
окончание: окончания
октябрь: октября
описание: описание
организация: организации
орден: орден ордена
ответственность: ответственности
отделение: отделения
отдельный: отдельных
отказ: отказ
отредактировать: отредактирована
оформить: оформил
ошибка: ошибке
п: п
памятник: памятника памятников
панов: панова
пантеон: пантеоне
перейти: перейти
персоналия: персоналии
персональный: персональные
песня: песня
печать: печати печать
площадь: площадь
победа: победы
поведение: поведения
подробный: подробнее
пожертвовать: пожертвовать
поиск: поиск поиску
политика: политика
получить: получить
последний: последний
постоянный: постоянная
поти: поти
похоронить: похороненные
похоронный: похоронен
почёт: почёта
почётный: почётные почётный
править: править
правка: правки
правление: правления
председатель: председатель
представиться: представились
премия: премии премия
примечание: примечания
продолжить: продолжил
проект: проектах проектом
просмотр: просмотры
пространство: пространства
прохоров: прохоров
пшавел: пшавела
работать: работал
разработчик: разработчики
реализм: реализм
ред: ред
республика: республики
ресурс: ресурсы
родиться: род родившиеся родился
рождение: рождении рождения
российский: российская
русский: русский
руставели: руставели
ряд: ряда
сабчот: сабчота
сакартветь: сакартвело
сведение: сведения
свежий: свежие
свободный: свободной
связанный: связанные
связаться: свяжитесь
секретарь: секретарь
сентябрь: сентября
серия: серии
система: системе
скачать: скачать
скрытый: скрытые
скульптор: скульптор скульпторы
скульптура: скульптуру скульптуры
слава: славы
словарь: словари
служебный: служебные
случай: случаях
случайный: случайная
смерть: смерти
смотреть: см
событие: события
советский: советская советский советской
содержание: содержание
создать: создать
сообщество: сообщество
сообщить: сообщить
сохранение: сохранением
социалистический: социалистический
соцреалист: соцреалисты
сочинение: сочинения
союз: союза
справка: справка
сср: сср
ссср: ссср
ссылка: ссылка ссылки
станция: станции
старый: старая
статистика: статистика
статья: статьи статья
стиль: стиль
страница: страница странице страницу страницы
сюда: сюда
так: т
тбилиси: тбилиси
тбилисский: тбилисская тбилисской
текст: текст
текущий: текущие
тифлис: тифлис тифлисе
товарный: товарный
трудовой: трудового
указание: указанием
указать: указан
укра: укра
улица: улица
умереть: умер
умерший: умершие
универсальный: универсальная
условие: условий условия
участие: участие
учиться: учился
учёба: учёба
учётный: учётную
фамилия: фамилией
фантазия: фантазия
февраль: февраля
фонд: фонд
форум: форум
художество: художеств
художник: художник художники художников
цитировать: цитировать
человек: людях
честь: чести
читать: читать
член: член члены
широта: ш
шота: шота
экспорт: экспорт
элгу: элгу
элгуджа: элгуджа
элемент: элемент
энциклопедия: энциклопедии энциклопедия
этот: эта
язык: язык языка языках
январь: января
