абад: абад
абгар: абгар
абгарян: абгарян
абкар: абкар
август: августа
авторство: авторства
академия: академии академию
акбар: акбар
алфавит: алфавиту
амер: амер
англ: англ
арма: арм
армянский: армянской армянском
архивировать: архивировано
биография: биография
болезнь: болезни
больший: большим
большой: большой
бурастан: бурастан
бывший: бывшего
век: века
версия: версия
викидать: викиданных
викимедиа: викимедиа
википедия: википедии википедия
вклад: вклад
внешний: внешние
возраст: возрасте
войти: войти
восхищение: восхищением
впоследствии: впоследствии
время: времени время
встретить: встречена
высокий: высшую
выставка: выставках выставкой выставку
выставлять: выставляла
гирих: гирих
год: года году лет
давотян: давотяна
дата: дата
дать: данная
дворец: дворца
действовать: действовать
день: день
деятельность: деятельности
джульфа: джульфы
диплом: диплом
дом: дом
дополнительный: дополнительные
доступный: доступен
другой: другие других
ещё: ещё
её: её
женщина: женщин женщина
живопись: живописи
заглавный: заглавная
занятие: занятий
запись: запись
зарегистрировать: зарегистрированный
затем: затем
заявление: заявление
знак: знак
значимый: значимые
избранный: избранные
известность: известностью
изолировать: изолированные
изящный: изящных
иллюминация: иллюминации
имя: имени имён
инструмент: инструменты
иран: иран ирана иране
ирано: ирано
иранский: иранская иранской
искусство: искусств
исламский: исламской
использование: использования
использовать: использующие
история: история
источник: источник
июль: июля
июнь: июня
категория: категории
кладбище: кладбище
клара: клара клары
код: код
кодекс: кодекс
конфиденциальность: конфиденциальности
королевский: королевского
короткий: короткий
который: которая
кук: куки
культура: культуры
культурный: культурного
лаковый: лаковой
литература: литература
лицензия: лицензии
магистр: магистра
май: мая
март: марта
мастер: мастеров
мастерская: мастерскую
материал: материал
международный: международный
место: место
миниатюра: миниатюр миниатюре
миниатюрист: миниатюрист
миниатюристка: миниатюристки
миниатюрный: миниатюрной
министерство: министерства
многий: многих
мобильный: мобильная
мохаммад: мохаммад
мочь: могут
музей: музее музеев музей
мы: нами
навигация: навигации навигация
наследие: наследия
национальный: национальном
начальный: начальное
недостаток: недостатков
некоммерческий: некоммерческой
неопр: неопр
несмотря: несмотря
новый: новой новые
ноябрь: ноября
образование: образование
обращение: обращения
обсуждение: обсуждение
обучаться: обучалась
описание: описание
организация: организации
ориентация: ориентации
ответственность: ответственности
отдельный: отдельных
отказ: отказ
открыть: открыт
ошибка: ошибке
первый: первая первой первую
перейти: перейти
перс: перс
персия: персия
персоналия: персоналии
персональный: персональные
печать: печати печать
плитка: плитке
поведение: поведения
подробный: подробнее
пожалуйста: пожалуйста
пожертвовать: пожертвовала пожертвовать
поиск: поиск поиску
политика: политика
получить: получила получить
пользоваться: пользовалась
поступить: поступила
похоронить: похоронена
правительство: правительства
править: править
правка: правки
право: правами
превратить: превратить
представить: представлены
представиться: представились
преподавание: преподавания
примерно: примерно
примечание: примечания
принять: принятыми
проверяться: проверялась
провести: провела
продажа: продажу
продолжительный: продолжительной
проект: проектах
просмотр: просмотры
пространство: пространства
пустой: пуст
работа: работ работу работы
разработчик: разработчики
распоряжение: распоряжению
расширение: расширение
рекомендация: рекомендациями
решить: решила
родиться: род родившиеся родилась
рождение: рождения
русский: русский
саад: саад
сад: садах
сведение: сведения
свежий: свежие
свободный: свободной
свой: свои свой
связанный: связанные
связать: связать
связаться: свяжитесь
семья: семье
система: системе
скачать: скачать
скрытый: скрытые
служебный: служебные
служить: служила
случай: случаях
случайный: случайная
смерть: смерти
смотреть: см
собственный: собственный
событие: события
содержание: содержание
создать: создать
сообщество: сообщество
сообщить: сообщить
соответствие: соответствии
соответствующий: соответствующими
сохранение: сохранением
справка: справка
ссылаться: ссылаются
ссылка: ссылки
статистика: статистика
статья: статьи статью статья
степень: степень
страна: страна
страница: страница странице страницы
сюда: сюда
таджвидти: таджвиди
также: также
такой: таких
тегеран: тегеран тегеране
тегеранский: тегеранского тегеранскую
текст: текст
текущий: текущие
тип: тип
товарный: товарный
трудность: трудности
указание: указанием
умереть: умерла
умерший: умершие
университет: университета
условие: условий условия
установить: установите
устроиться: устроилась
участие: участие
участник: участниками
учётный: учётную
финансовый: финансовые
фонд: фонд
форум: форум
хади: хади
художественный: художественной
художник: художник художники
художница: художница художницы
цитата: цитата
человек: человек
читать: читать
член: членом
шаблон: шаблон шаблонами
школа: школе школу
эксперт: экспертом
экспонироваться: экспонируются
экспорт: экспорт
элемент: элемент
энциклопедия: энциклопедии
этот: этому
язык: языках
январь: января
