абсурд: абсурдом
авангард: авангарда
август: августа
австрия: австрию
автовый: автово
автор: автор
автореферат: автореферат
авторский: авторские
авторство: авторства
агитация: агитацию
агрессивный: агрессивен
адресат: адресат
академический: академический
академия: академии
активный: активен активное
алекс: алекса
александр: александр александра александром
александрийский: александрийской
алексеевич: алексеевна
алеф: алеф
алфавит: алфавиту
аналогия: аналогии
андреев: андреева
анкета: анкету
антисоветский: антисоветские антисоветскую
аполитичность: аполитичности
апрель: апреле апреля
аре: аре
арестовать: арестован
арефьев: арефьев арефьева арефьевой арефьеву арефьевым
арефьевский: арефьевский
арех: арех ареха
архив: архив
архивировать: архивировано
архивный: архивная
архитектор: архитектор
архитектура: архитектуры
б: б
барбизон: барбизон
баржа: баржи
бедный: бедны бедных
безлюдный: безлюдные
беспутный: беспутные
бетонный: бетонная
библиографический: библиографическими библиографических
билет: билет
биография: биография
бить: била
благодаря: благодаря
благодатов: благодатова
близкие: близким
близкий: близкого
блокада: блокаду блокады
бобринский: бобринская
болезнь: болезни
больший: большая большим
большинство: большинстве
борисович: борисовна
брак: браке
брандмауэр: брандмауэры
брансвика: брансвик
брат: брат братом
братский: братской
брать: берут
бреус: бреус
бродить: бродит
бродячий: бродячий
буксир: буксиры
бывший: бывшим
быстро: быстро
быт: быта
быть: будучи е
вадим: вадим вадима
важно: важно
валентин: валентин
валерий: валерий
васильевский: васильевский
васми: васми
вахтанг: вахтанг вахтанга
ведерников: ведерникова ведерниковым
век: века веке
великий: великой
вена: вене
вера: вера веру
версия: версии версия
вести: ведут ведёт вёл
весь: всём
вечерний: вечернюю
вид: вид
видение: видения
видеть: видел видели
видоизмениться: видоизменилась
викидать: викиданных
викимедиа: викимедиа
википедия: википедии википедия
вит: вита
вклад: вклад
владеть: владеет
владимир: владимир владимира
владимирович: владимирович владимировна
влияние: влияние
вместе: вместе
вместо: вместо
внезапно: внезапно
внешний: внешние
внутренний: внутренней
вода: воде
водкина: водкина
военный: военно
возможно: возможно
возможность: возможности
война: войну войны
войти: войти
войцеховский: войцеховский войцеховским войцеховского
вокруг: вокруг
волна: волна волны
волшебный: волшебные
вольный: вольную
воплощать: воплощает
восемь: восемь
воспитывать: воспитывали
воспоминание: воспоминанию воспоминания воспоминаниям
восстановиться: восстановился
впечатление: впечатление впечатлением впечатления
время: времени время
вручить: вручили
врываться: врывался
всадник: всадника
встретить: встреченным
встреча: встречи
вступать: вступает
всякий: всякая всякой всякому
всё: всё
вторично: вторично
второй: вторая
втроём: втроём
входить: входят
выбрать: выбрать
вывезти: вывезен
выйти: выйдя
выражение: выражение выражения
выразительный: выразительной выразительные выразительными
высокий: высоким
выставка: выставка выставках выставке выставки выставок
выставочный: выставочную выставочный
выступление: выступление выступления
г: г
газ: газа
галарт: галарт
ге: ге
генеалогия: генеалогия
георгиевич: георгиевич
георгий: георгий георгия
героизм: героизм
герой: герои
гигиенический: гигиенический
глазунов: глазунов глазунова
глухой: глухие глухим
говорить: говорили
год: гг год года годам годах годов году годы лет
гонение: гонения
гордо: гордо
гореть: горящим
горком: горкома
город: город города
городской: городские
горожанин: горожан
горохов: горохова
гороховый: гороховой
государственный: государственного государственный
гражданский: гражданском
гражданство: гражданство
график: график
графика: графики графикой
греция: греции
громов: громов громова
группа: групп группа группу группы
гудзенко: гудзенко
гуревич: гуревич
давидович: давидович
далее: д далее
даниил: даниила
дата: дата
дать: дали
два: две двумя
движение: движения
двор: дворы
дворец: дворце
дворик: дворики
действовать: действовать
делаться: делался
дело: делу
день: днях
детгиз: детгиз
детский: детская детской
деятельность: деятельности
диорама: диорам
дисса: дисс
диссертация: диссертации
дк: дк
дми: дми
дмитриевич: дмитриевич
дмитрий: дмитрий дмитрия
дневник: дневники
дневниковый: дневниковые
должный: должна
дом: дом дома доме
домой: домой
дополнительный: дополнительные
дорожка: дорожка
доротея: доротеей
достаточный: достаточной достаточными
доступный: доступен
досыта: досыта
дочь: дочерью
др: др
друг: друг друга другом другу друзей друзья друзьями
другой: другие другим других
друскин: друскин друскина
друскина: друскиной
дубравлага: дубравлаге
дух: духа
дышленко: дышленко
еврейский: еврейской
егоров: егорова
единственный: единственным
есть: ел
ехать: едущие
ещё: ещё
её: её
жанна: жанна жанной
жанровый: жанровые
жданов: жданова
жена: жена женой жену
жестокий: жестокие
живой: живая
живописец: живописец живописцев
живописно: живописно
живописный: живописную живописным
живопись: живописи живопись живописью
жизнь: жизни жизнь
жить: живём живёт жил жила жили
журнал: журнал
забытый: забыто
заглавный: заглавная
заимствовать: заимствованным
заканчивать: заканчивает
заключаться: заключается
закончить: закончил закончила
зал: зал
заменить: заменить
замочный: замочную
замысел: замыслах
занести: занесённые
заниматься: занимался заниматься
заочный: заочное
западный: западной
запись: записи запись
запретить: запрещена запрещены
зарабатывать: зарабатывали
зарегистрировать: зарегистрированный
застать: застал
затем: затем
заходить: заходил
захоронение: захоронения
заявление: заявление
звание: звание
звонкий: звонкая
знак: знак знаком
знакомиться: знакомился знакомится
знакомый: знакомые
знать: знал знать знаю
значение: значение
значит: значит
значительно: значительно
иванович: ивановна
игра: игрой
играть: играя
идея: идеи идеям
идти: идущие шли шло
иерусалим: иерусалиме
ижс: ижса
избранный: избранные
издательство: издательством
изнутри: изнутри
изображать: изображает изображать
изображение: изображений изображению изображения
икона: икон
иллюстратор: иллюстратор
илья: ильи илья
именно: именно
иметь: имела
император: императором
империя: империи
импрессионист: импрессионистов
импульс: импульс
имя: имён
ингала: ингала
иной: иные
иностранец: иностранцами
институт: институт института институте
инструмент: инструмент инструменты
интенсивный: интенсивному
интересно: интересно
интересный: интересных
интересовать: интересовала
исключить: исключили исключён
искусство: искусства искусстве искусство искусством
искусствоведение: искусствоведения
искусствознание: искусствознания
использование: использование использования
использовать: использующие
испытать: испытав
истинный: истинное
история: истории история
источник: источник источниками источники
исходить: исходил
июнь: июня
йорк: йорка
казаться: кажется
какой: какие
канд: канд
кардинал: кардиналом
карпов: карпова
картина: картинах картины
карьеризм: карьеризму
каталог: каталог каталогах
категория: категории
католический: католическим
католичество: католичество
кафедра: кафедре
качаться: качаются
квартира: квартир квартира
квартирный: квартирной квартирные квартирных
кекелидзе: кекелидзе
кжой: кжои
кирилл: кирилл кирилла
кировский: кировском
кладбище: кладбище
кладбищенский: кладбищенских
класс: классе
ключ: ключом
книга: книги
книжный: книжной книжный
код: код
кодекс: кодекс
коллективный: коллективной
коллекция: коллекции коллекция
коломна: коломна
колонна: колонн
колпаков: колпакова
комбинат: комбинате
коммунальный: коммунальных
комната: комнатах
композиция: композиций
конец: конце
конкретность: конкретность
конфиденциальность: конфиденциальности
концепция: концепции
конь: коне коня
копиист: копиист
копия: копию копия
корндорф: корндорф
короткий: короткий
коснуться: коснулись
который: которая которого котором которую которые который которых
краска: красками
красненький: красненьком
красота: красота красотой
креститься: крестился
кроме: кроме
круг: круг круга
кружкова: кружкова
кто: кому
кудрявцев: кудрявцева
кук: куки
культура: культуры
купить: купить
курс: курс курсе
кушнир: кушнира
л: л
лагер: лагере
лагерь: лагеря
лапшин: лапшина лапшиным
лариса: лариса
ларёк: ларьки ларьков
лашез: лашез
лвхп: лвхпу
лев: льва
левин: левин левина
ленинград: ленинград ленинграда ленинграде
ленинградец: ленинградцев
ленинградский: ленинградская ленинградский ленинградского ленинградской ленинградскую
леонид: леонид леонида
лечение: лечения
либо: либо
лидер: лидером
лик: лики
лильбок: лильбок лильбока
линия: линии линию линия
лирика: лирики
лист: лист
литература: литература
лицей: лицей
лицензия: лицензии
лицо: лицо
лосха: лосх
лош: лош
любить: любил
любовный: любовной
любовь: любовь
любой: любой
м: м
мазка: мазок
май: мае мая
макетчик: макетчик
маленький: маленькие
мальчик: мальчики
мандельштам: мандельштам мандельштама мандельштамом
манеж: манеж
мариинский: мариинском
мария: мария
марка: марке
маркевич: маркевич
мастер: мастера мастеров
мастерская: мастерских мастерской
материал: материал материала
мать: матерью мать
медаль: медалью
медицинский: медицинский медицинских медицинской
медный: медного
мемориальный: мемориальный
место: местах месте место
месяц: месяцев
мир: мир
миронов: миронов
митька: митьки
миф: мифы
михаил: михаил михаила михаилом
многий: многими
многократно: многократно
многочисленный: многочисленным
мобильный: мобильная
могила: могила могиле могилу
модель: модель
модлина: модлина модлиной
молодой: молодой молодые молодых
молодёжный: молодёжную
молодёжь: молодёжь
монументальный: монументальных
морг: морг
мордовия: мордовии
москва: москве москву
московский: московские московского московской московскую
мост: мост мосты
мотив: мотива мотиву
моховой: моховую
мочь: могли могут
музей: музее музей музея
мухин: мухиной
мы: нам нами
н: н
набережный: набережные
наблюдение: наблюдения
наблюсти: наблюдённое
навигация: навигации навигация
наградить: награждён
название: название
называть: называет называла называть
налево: налево
наличие: наличие
написать: написал
направление: направлений
напрямую: напрямую
наращивать: наращивает
наркоманить: наркоманил
нарушать: нарушать
наслаждаться: наслаждаемся
наследие: наследие
настолько: настолько
насыщаться: насыщался
наталья: натальи
натура: натуры
научно: научно
находить: находит
находиться: находился находятся
начало: начала начале
начать: начали
начаться: начались начаться
начинать: начинает начинали
наш: наш наших
ндр: ндр
неавторитетный: неавторитетными
небольшой: небольшие небольших небольшой небольшом
невероятный: невероятной
неврологический: неврологическом
невский: невский
недалеко: недалеко
недостаток: недостатков
недоступный: недоступная
незаурядный: незаурядного
некоммерческий: некоммерческой
некоторый: некоторые
некрополистик: некрополистика
нелепость: нелепостями
необходимо: необходимо
необычность: необычностью
неопр: неопр
неофициальный: неофициального неофициальное
неприглядный: неприглядные
непродающийся: непродающихся
непустой: непустое
нерабочий: нерабочими
нередко: нередко
несколько: нескольких несколько
нигде: нигде
никакой: никаких
николай: николай николая
нина: нина
ничто: ничто
нищенствовать: нищенствующих
новгород: новгорода
новгородский: новгородскую
новый: нова новейших новой новом новые новый
нонконформист: нонконформистов
нонконформистский: нонконформистского
носить: носить
ночевать: ночуя
ноябрь: ноября
нужно: нужно
ныне: ныне
нью: нью
оба: оба
обвинение: обвинение
обед: обед
область: область
оборона: обороне оборону
образ: образ образом
образовательный: образовательный
обратиться: обратился
обращение: обращения
обсуждение: обсуждение обсуждения
общаться: общался
общение: общения
общество: общества
общий: общей общий
объединиться: объединившихся объединились объединятся
объект: объект объекта
объём: объём
овчинников: овчинникова
ограничение: ограничении
один: одного одной одном одному
однажды: однажды
однородный: однородной
означать: означает означало
оказаться: оказалось оказался
окно: окна окно
октябрьский: октябрьской
он: нему нём
онж: онж
они: ими ними
ооо: ооо
опережать: опережал
описание: описание
опосредованно: опосредованно
определённый: определенный
опытный: опытными
организация: организации организацию
орден: орден ордена ордене орденом
оригинал: оригинала
оригинально: оригинально
оригинальный: оригинальное оригинальный
ориентация: ориентация
осадить: осажденном
освещать: освещают
освободить: освобождён
освобождение: освобождения
основать: основанным
основное: основном
особенно: особенно
особенность: особенности
оставить: оставил
остановка: остановках
остаться: остался
остров: остров
осудить: осужден осуждён
отбывать: отбывал
отбыть: отбыл
ответственность: ответственности
отделение: отделение отделении отделения
отдельный: отдельных
отец: отец отца отце отцом
отказ: отказ
открытие: открытии
отличаться: отличаться
отмечать: отмечает
относиться: относятся
отношение: отношения
отнюдь: отнюдь
отображать: отображал
отображение: отображения
отобразить: отображённого
отредактировать: отредактирована
оттуда: оттуда
отчислить: отчислен отчисленные отчислены
отчётливо: отчётливо
оформитель: оформитель
оформительский: оформительского
оформление: оформления
очень: очень
ошибка: ошибке
п: п
памятник: памятник памятника памятников
память: памяти память
парадное: парадного
париж: париж париже
патентованный: патентованная
пафос: пафос
педагог: педагога педагогов
пейзаж: пейзаж пейзажа пейзажи
пейзажист: пейзажисты
пейзажный: пейзажная пейзажной
пекшева: пекшев
пер: пер
первостепенный: первостепенную
первый: первая первой первом первые
переводчица: переводчица
переделать: переделал
переезжать: переезжает
пережить: переживших
переиначить: переиначив
перейти: перейти
перекрёсток: перекрёстке
перенести: перенеся
пересекаться: пересекались
персона: персона
персоналия: персоналии
персональный: персональные
песня: песен
петербург: петербург петербурга петербурге
петербургский: петербургских
петергоф: петергоф
петров: петрова
петроградский: петроградской
петродворец: петродворец
печатный: печатной печатные
печать: печати печать
пивной: пивных
пионер: пионеров
писать: писали пишем
планировать: планировал
площадь: площадей
поведение: поведения
повлиять: повлиял повлияли повлияло
повседневный: повседневной
повсюду: повсюду
повторять: повторяя
подворотня: подворотни
подгот: подгот
подготовка: подготовке
подделка: подделку
подделывать: подделывал
поддержать: поддержали поддержать
подобный: подобные подобных
подробный: подробнее
подружиться: подружился
подтверждать: подтверждаемым
подхватить: подхватили
подхватывать: подхватывал
подход: подхода
подхоронить: подхоронен
подчеркнуть: подчеркнуть
подчиняться: подчиняться
пожертвовать: пожертвовать
поздний: позднего позднее
познакомиться: познакомился
поиск: поиск поиску
пойти: пошло
пока: пока
показывать: показывали
поколение: поколения
полезный: полезное
полиграфический: полиграфического
политика: политика
политический: политическое
полностью: полностью
половина: половина
полтава: полтава полтаве
получить: полученное получившей получила получить
понимать: понимает
пономарёв: пономарёва пономарёвой
попасть: попал
попытаться: попытаться
попытка: попытку
портал: портал
посвятить: посвятившим
последний: последней последние последний
поставить: поставить поставлен
постоянно: постоянно
постоянный: постоянная
поступать: поступает
поступить: поступил
потерять: потерял
потрясать: потрясающий потрясающим
похоронить: похороненные
похоронный: похоронен
поэт: поэт поэта поэтом
поэтесса: поэтесса
праведник: праведники
правило: правилам
править: править
правка: правки правок
право: права
прасоловый: прасолова
прах: прах
предпочтение: предпочтения
председатель: председатель
представиться: представились
предъявить: предъявлено
преемник: преемниками
преловский: преловский преловского
преподавать: преподавал
приверженность: приверженность
приводить: приводил приводит
пригласить: приглашённым
придумать: придумал придумано
приехать: приехавших приехал
признанный: признанных
признать: признаны
применяться: применяется
примеч: примеч
примечание: примечания
примитив: примитивом
принимать: принимает
принятие: принятие
принять: принял
прислать: пришли
присутствовать: присутствует
притащить: притащил
причина: причинам
проблемный: проблемных
пробовать: пробует
пробштейн: пробштейн
проверить: проверенной
проверка: проверки
проверяться: проверялась
проводить: проводит проводить
провокационность: провокационность
продажа: продажи
продолжение: продолжение
продолжительный: продолжительной
продукция: продукции
проект: проект проектах
произведение: произведения
происходить: происходит
пропаганда: пропаганду
просмотр: просмотры
проспект: проспекте
просто: просто
пространство: пространства
протест: протеста
противоположный: противоположны
профессионал: профессионалы
проходить: проходит
процесс: процессе
прочее: прочего
прп: прп
прыгать: прыгающего
публичный: публичного публичный
пункт: пункт
путь: пути
пятидесятник: пятидесятники
пятидесятый: пятидесятых
пятница: пятниц
пять: пять
р: р
рабле: рабле
работа: работах работе работу работы
работать: работавших работает работал работали
рабочий: рабочих
разбойник: разбойника
развивать: развивая
развращать: развращает
разговор: разговоры
различный: различных
размер: размеру
разработчик: разработчики
рано: рано
распятие: распятия
рассказывать: рассказывает рассказывал рассказывать
реальность: реальности
ребята: ребят
ревекка: ревекка
революция: революции
ред: ред
редактор: редакторам
редкий: редчайший
редкость: редкостью
религиозный: религиозный
религия: религии
репин: репина
репродукция: репродукции репродукциям
ресурс: ресурсы
рецепт: рецептов рецепты
решетняк: решетняка
ривкина: ривкина
рисование: рисованию
рисовать: рисуем
рисунок: рисунки рисунков
рихард: рихард рихарда
роальд: роальд роальдом
родион: родион родиона
родиться: род родившиеся родился
рождение: рождения
роль: роль
российский: российская российской
россия: россии
роттердамский: роттердамского
рсфср: рсфср
рудольф: рудольф
рука: руках
русаков: русаковым
русакова: русакова
русский: русские русский русским русской
рыцарь: рыцарей рыцари рыцарям
ряд: ряд
сайт: сайты
сам: самом
санитарный: санитарно
санкт: санкт
сб: сб
сближать: сближающее
сборник: сборник
сведение: сведения сведениям
свежий: свежие
свет: свет свете
свободный: свободной
свой: своего своему своею свои своим своих свой своё
связанный: связанные
связать: связана связанная
связаться: свяжитесь
связывать: связывала
святой: святой
секция: секция
семья: семье семьи семью семья
сентябрь: сентябре сентября
середина: середине
серьёзный: серьёзные
сестра: сестрами
сжатый: сжатому
сибирь: сибири
сидеть: сидел сидящие
силуэт: силуэтов
сильно: сильно
символ: символы
символичный: символичные
сирота: сиротой
система: системе
скамейка: скамейках
скачать: скачать
скважина: скважину
сквер: скверах
скверик: скверики
склеп: склепах
склонить: склонил
скобкина: скобкина
скрытый: скрытой скрытые
скульптор: скульптор
скупой: скупое
слава: слава
славист: славистом
следить: следили
следовать: следует
следствие: следствием
словарь: словари
слоёный: слоеного
служебный: служебные
служение: служения
случай: случаев случаях
случайно: случайно
случайный: случайная
смерть: смерти
смотреть: см
смысловой: смысловой
сначала: сначала
собрание: собрание собрании собранию собрания собраниях
событие: события
совершенно: совершенно
советский: советский советского советскому
совместно: совместно
современность: современности
современный: современного современной
согласно: согласно
содержание: содержание
содержимое: содержимым
создавать: создавая создаёт
создание: создание создания
создать: создал создать
сознательно: сознательно
соколов: соколов
сокурсница: сокурсница
соломон: соломон
сообщество: сообщество
сообщить: сообщить
соответствующий: соответствующие
соприкосновение: соприкосновения
сороковой: сороковых
сортир: сортир
сост: сост
составлять: составляющая
сотня: сотни
сотрудничать: сотрудничает
соученик: соучениками
сохранение: сохранением
сохранить: сохранил
социалистический: социалистической
соцреализм: соцреализма
соч: соч
сочинять: сочиняя
союз: союза
спам: спам
спб: спб
спбгаижс: спбгаижса
список: список
спицын: спицыной
справка: справка
справочный: справочно
сразу: сразу
среда: среду
среди: среди
средний: среднюю
средство: средствами
срок: срок
срочно: срочно
ссср: ссср
ссылка: ссылка ссылками ссылки ссылок
становиться: становится становятся
стараться: старались
старший: старшего старших
статистика: статистика
стать: стал стали статей
статья: статье статьи статья
степанович: степанович
стерлигов: стерлигов стерлиговым
стильный: стильная
сторона: стороне стороны
стоять: стояло
стоящий: стоящие
страдать: страдающие
страница: страниц страница странице страницу страницы
стратегия: стратегии
страшно: страшно
стремиться: стремился
струкова: струкова
суриковский: суриковский
сформулировать: сформулировать
сх: сх
сходство: сходство
схш: схш
сцена: сцены
сша: сша
сын: сына сыном
сюда: сюда
сюжет: сюжетом
таврический: таврическое
тайна: тайна
так: т
также: также
такой: такая такие такими
татьяна: татьяна
творчество: творчества творчестве творчество творчеством
театр: театре
текст: текст текста
текущий: текущая текущие
тема: темы
темнота: темноте
термин: термином
территория: территории
тесно: тесно
типографский: типографские
титов: титов
товарищ: товарищ товарищей товарищи
товарищество: товарищества
товарный: товарный
тонус: тонус
тот: тех ту
точнее: точнее
точность: точность
традиция: традиции традиция
трамвайный: трамвайных
траугот: траугот траугота трауготом
требование: требованиям
требовать: требуют
требоваться: требовалось
третий: третьей
триевич: триевич
трое: троих
труд: труда
туда: туда
тунеядец: тунеядцев
тщета: тщета
тырс: тырсы
тьма: тьма
тюрьма: тюрьма тюрьмы
тяжёлый: тяжёлая
увлечь: увлечённые
уголовный: уголовная
удалить: удалить
узкий: узкий
узор: узора
уйти: ушли
указ: указ
указание: указанием
указать: указан
украина: украины
улица: улицах
умение: умением
умереть: умер
умерший: умершие умершим
умирать: умирает
университет: университет
упрощение: упрощением
урожд: урожд
ускользать: ускользающего
условие: условий условия
успешно: успешно
установка: установкам установкой
устроить: устроил
устроиться: устроиться
участвовать: участвует
участие: участие
участник: участниками
участок: участок
ученик: ученик ученикам учеником
ученица: ученицы
училище: училище
учиться: учились учился учиться
учредить: учреждённом
учётный: учётную
ф: ф
факт: факт
фактура: фактура фактуры
факультет: факультет
фамилия: фамилией
февраль: февраля
фешина: фешина
филолог: филолог
философ: философ
фомин: фомин
фонарь: фонарями
фонд: фонд фонда
форма: форме
формалист: формалистов
формальный: формальным
форум: форум
франсуа: франсуа
франция: франции францию франция
французский: французским французских
фридман: фридмана
фронтинский: фронтинского
фьев: фьев
х: х
характеризоваться: характеризующуюся
характерный: характерно
ход: хода
холст: холсты
хоронить: хоронит
хороший: хорошие хороший
хотя: хотя
христианский: христианскую
христос: христа
художественный: художественная художественного художественную
художество: художеств
художник: художник художника художниками художники художников художником
художница: художницей художницы
хулиганство: хулиганство
хх: хх
царскосельский: царскосельская
цвет: цвет цвета
цвз: цвз
цель: цели
центр: центр
центральный: центральный
цитировать: цитировать
ч: ч
чарльсович: чарльсовичем
частный: частные
часто: часто
чахлый: чахлые
человек: людей люди людьми людях человек человека человеком
чистый: чистый
читать: читать
читаться: читается
член: член членом члены
членство: членство
чувство: чувство
чугунный: чугунного
чуждый: чужд
чужой: чужие
чуткий: чуткий
чч: чч
чёрный: чёрного
шаблон: шаблон шаблонами
шагин: шагин шагина шагиным
шалить: шаля
шварц: шварц шварцем
шемякин: шемякина шемякиной шемякиным
шестидесятник: шестидесятники
шестидесятый: шестидесятым
шестнадцать: шестнадцать
шесть: шесть
шинкарёв: шинкарёва
широта: ш
школа: школа школу школы
шолом: шолом
шпиль: шпилей
шрифт: шрифты
шурик: шурик
эвакуация: эвакуацию
эквивалент: эквивалент
эксперимент: эксперимент
экспериментальный: экспериментальных
экспозиция: экспозиции
экспонирование: экспонирования
экспорт: экспорт
экспрессионизм: экспрессионизм
экспрессионизь: экспрессионизи
элемент: элемент
эмигрант: эмигранты
эмигрировать: эмигрировал эмигрировала
эмоциональный: эмоциональная
энциклопедия: энциклопедии
эразм: эразма
эрмитаж: эрмитажа эрмитаже
эрудит: эрудитом
эссе: эссе
эстетически: эстетически
эстетический: эстетическим
это: этим это
этот: эта этих
ю: ю
юдин: юдина
являться: является
язык: язык языках языки языку
яковлевич: яковлевич
ян: ян
январь: января
яновый: янова яновой
яростно: яростно
яценко: яценко
