авторство: авторства
академик: академик
академия: академии
алфавит: алфавиту
анна: анны
арзуман: арзуманов
арзуманов: арзуманова
армянский: армянской
архивировать: архивировано
биография: биографии биография
бой: бой
бунтовать: бунтующие
валерий: валерий валерия
век: века
версия: версии версия
ветеран: ветерана
викидать: викиданных
викимедиа: викимедиа
википедия: википедии википедия
викисклад: викисклад викискладе
вклад: вклад
вов: вов
войти: войти
втоо: втоо
выпускник: выпускники
выступление: выступление
галерея: галерей
год: года году
губернатор: губернатора
дата: дата
действовать: действовать
декабрь: декабря
день: день
деятель: деятели
деятельность: деятельности деятельность
дизайн: дизайна
директор: директор
добавить: добавить
дополнительный: дополнительные
доступный: доступен
дочь: дочери
другой: других
ещё: ещё
жить: живёт
заглавный: заглавная
занятие: занятий
запись: запись
зарегистрировать: зарегистрированный
заслужить: заслуженные заслуженный
заявление: заявление
звание: звания
знак: знак
значительно: значительно
золотой: золотая золотые
избранный: избранные
избрать: избран
изображение: изображений
изобразительный: изобразительного
имя: имени имён
институт: институт
инструмент: инструменты
искусство: искусства
использование: использования
история: история
источник: источник
категория: категории
код: код
кодекс: кодекс
коллегия: коллегии
коллекция: коллекциях
комаров: комарова
конфиденциальность: конфиденциальности
конь: коня
короткий: короткий
корреспондент: корреспондент корреспондентом корреспонденты
краевой: краевого краевое
край: край края
красный: красного
кук: куки
культура: культуры
курган: курганов
лицензия: лицензии
м: м
май: мая
материал: материал
медаль: медаль
медиафайл: медиафайлы
место: место
министерство: министерства
мобильный: мобильная
мочь: могут
мы: нами
навигация: навигации навигация
награда: награды
народный: народные народный
некоммерческий: некоммерческой
неопр: неопр
николаевич: николаевич николаевича
новый: новые
область: области
обращение: обращения
обсуждение: обсуждение
окончить: окончил
описание: описание
опытный: опытными
организация: организации
основной: основные
ответственность: ответственности
отделение: отделения
отдельный: отдельных
отказ: отказ
отличаться: отличаться
отредактировать: отредактирована
ошибка: ошибке
педагог: педагогов
перейти: перейти
персоналия: персоналии
персональный: персональные
печать: печати печать
поведение: поведения
подробный: подробнее
пожертвовать: пожертвовать
поиск: поиск поиску
пока: пока
политехнический: политехнический
политика: политика
получить: получить
портрет: портрет
последний: последний
постоянный: постоянная
править: править
правка: правки
правление: правления
представить: представлены
представиться: представились
президент: президента
премия: премия
примечание: примечания
проверить: проверенной
проверка: проверки
проверяться: проверялась
проект: проектах
произведение: произведения
просмотр: просмотры
пространство: пространства
профессор: профессор
пятигорск: пятигорск пятигорске
работа: работы
работать: работает
разработчик: разработчики
рах: рах
региональный: регионального
ректор: ректора
родиться: род родившиеся родился
рождение: рождения
российский: российский российской
россия: россии россия
рсфср: рсфср
рубеж: рубежом
русский: русский
рф: рф
сведение: сведения
свежий: свежие
свободный: свободной
связанный: связанные
связаться: свяжитесь
седой: седых
сей: сей
секретарь: секретарь
семья: семье
сентябрь: сентября
серебряный: серебряная
система: системе
скачать: скачать
скрытый: скрытые
служебный: служебные
случай: случаях
случайный: случайная
смотреть: см
собрание: собраниях
событие: события
советский: советский
современник: современников
содержание: содержание
создать: создать
сообщество: сообщество
сообщить: сообщить
сохранение: сохранением
союз: союз союза
справка: справка
ссср: ссср
ссылка: ссылка ссылки
ставрополье: ставрополья
ставропольский: ставропольский ставропольского ставропольское
статистика: статистика
статья: статьи статья
страна: страна
страница: страница странице страницу страницы
суриков: сурикова
сюда: сюда
тайна: тайна
творческий: творческая
текст: текст
текущий: текущая текущие
тип: тип
товарный: товарный
тополь: тополя
требовать: требуют
уваров: уварова
указ: указ
указание: указанием
условие: условий условия
участие: участие
участник: участниками
училище: училища училище
учётный: учётную
фамилия: фамилией
февраль: февраля
федерация: федерации
фонд: фонд
форум: форум
хранительница: хранительница
художественный: художественного художественное художественных
художество: художеств
художник: художник художника художники художников
цитировать: цитировать
частный: частных
человек: людях человек
читать: читать
член: член членом члены
шар: шары
экспорт: экспорт
элемент: элемент
энциклопедия: энциклопедии
этот: эта
юг: югу
южный: южного
язык: языках
