авено: авен
авторство: авторства
академия: академии академию академия
акварелист: акварелистом
алфавит: алфавиту
амьё: амье
англ: англ
апрель: апреле апреля
архивариус: архивариусом
архивировать: архивировано
ателье: ателье
беларускать: беларуская
берн: берн берна
бернский: бернского
библиографический: библиографических
биография: биография
близкие: близким
больший: большая
боннар: боннаром
боннара: боннара
брать: берет брать
бретань: бретань
бруно: бруно
быть: будучи
валлотон: валлотоном
вд: вд
век: века
венский: венский
версия: версия
викидать: викиданных
викимедиа: викимедиа
википедия: википедии википедия
викисклад: викисклад викискладе
вклад: вклад
влияние: влияние
вместе: вместе
внести: внести
внешний: внешние
воззвание: воззвания
война: войны
войти: войти
волшебный: волшебные
вольфсберг: вольфсберг
воспитание: воспитание
время: время
вступать: вступает
выпускник: выпускники
выставка: выставка выставку
вюйярый: вюйяра
габриэль: габриэль
галерея: галерее
генеалогия: генеалогия
геоцепочка: геоцепочками
герман: герман германа
гесс: гессе
гоген: гоген
год: года году
городок: городок
государственный: государственным
гравёр: гравёр
график: график
графика: графики
графический: графический
группа: группа группу
гузис: гузис
давать: дает
дата: дата
датский: датская
движение: движении
дворец: дворце
действовать: действовать
декорация: декорации
демме: демме
дени: дени
деятель: деятели
деятельность: деятельности
дж: дж
джакометти: джакометти
джованни: джованни
дизайнер: дизайнер
доктор: доктор доктора
дом: доме
дополнительный: дополнительные
доступный: доступен
дрезденский: дрезденской
друг: другом
другой: других
дружба: дружбу
ещё: ещё
её: её
жанр: жанр
желательно: желательно
живописец: живописец
живопись: живописи
жизнь: жизни жизнь
жить: жил
жюлиан: жюлиана
заглавный: заглавная
запись: запись
зарегистрировать: зарегистрированный
заявление: заявление
збекча: збекча
звание: звание
зееберг: зееберг
знак: знак
знакомиться: знакомится
золотурна: золотурн золотурна
золотурне: золотурне
избранный: избранные
изобразительный: изобразительного
изящный: изящных
имя: имён
инструмент: инструменты
интересовать: интересовало
исключить: исключите
искусство: искусств искусства искусстве
исполнить: исполненный
использование: использования
использовать: использующие
исправление: исправления
исторический: исторический
история: история
источник: источник источниками источники
июль: июля
июнь: июня
кантон: кантона
карл: карл
картон: картона
каталанский: каталанская
каталог: каталогах
категория: категории
квалификатор: квалификаторах
кисть: кисти
код: код
кодекс: кодекс
колония: колонии
композиция: композиции
конфиденциальность: конфиденциальности
короткий: короткий
который: которого котором которым
крупный: крупным
кук: куки
куно: куно
летие: летию
лист: листе
листок: листки
литература: литература
литовский: литовская
лицензия: лицензии
мазок: мазками
май: мае
март: марта
мастер: мастера
мастерство: мастерство
материал: материал
медиафайл: медиафайлы
место: место
мировой: мировой
мобильный: мобильная
молодой: молодых
морис: мориса
мост: мост
мочь: могут
музей: музее музей
мы: нами
мюнхен: мюнхен
мюнхенский: мюнхенская мюнхенской мюнхенском
наби: наби
навигация: навигации навигация
награда: награды
называть: называли
направление: направлению
настенный: настенные
начать: начал
начинающий: начинающему
недостаток: недостатки недостатков
недоступный: недоступная
некоммерческий: некоммерческой
некрополистик: некрополистика
немой: нем
неоднозначный: неоднозначными
неопр: неопр
нерабочий: нерабочими
нидерл: нидерл
николаос: николаос
новый: новые
норвежский: норвежская
оба: оба
обозначить: обозначен
обращение: обращения
обсуждение: обсуждение
обучаться: обучавшиеся
оказать: оказал
октябрь: октябре
описание: описание
организация: организации
организовать: организуют
организоваться: организуется
осень: осенью
оставаться: остаётся
ответственность: ответственности
отдать: отдавшим
отдельный: отдельных
отец: отец
отказ: отказ
отредактировать: отредактирована
ошванда: ошванд
ошибка: ошибке
память: памяти
париж: париж
пауль: паулем
первый: первой первые первым
перейти: перейти
персоналия: персоналии
персональный: персональные
печать: печати печать
пионер: пионером
писатель: писателя
поведение: поведения
погибнуть: погибло
подробный: подробнее
пожар: пожара
пожертвовать: пожертвовать
поиск: поиск поиску
поле: поля
политика: политика
политический: политические
получить: получить
поль: поль
понт: понт
портрет: портрет
посещать: посещает
посещение: посещения
последний: последнего последний
постимпрессионизм: постимпрессионизм
постимпрессионист: постимпрессионисты
постимпрессионистский: постимпрессионистскому
постоянный: постоянная
поступать: поступает поступают
почётный: почётного почётные почётный
править: править
правка: правки
преамбула: преамбуле
предпочтение: предпочтение
представиться: представились
примечание: примечания
принадлежать: принадлежит
присваиваться: присваивается
проблема: проблемы
проект: проектах
просмотр: просмотры
проставить: проставить
пространство: пространства
против: против
псевдоним: псевдонимом
публиковать: публиковал
пьер: пьера
работа: работ работы
работать: работал
разработчик: разработчики
рауп: рауп
ресурс: ресурсы
ретроспективный: ретроспективная
рисование: рисования
рихтер: рихтер
робер: робера
родиться: род родившиеся родился
рождение: рождения
русский: русский
рыбацкий: рыбацкий
сайт: сайты
салон: салоне
сведение: сведения
свежий: свежие
свободный: свободной
свой: свои
связанный: связанные
связаться: свяжитесь
сегантини: сегантини
семья: семье
серюзье: серюзье
сецессион: сецессион
сильный: сильное
символист: символистов символистом
синклер: синклера
система: системе
скачать: скачать
скрытый: скрытые
скульптор: скульптор скульпторы
скупой: скупыми
словарь: словари
служебный: служебные
случай: случаях
случайный: случайная
смерть: смерти
смотреть: см
сноска: сноски сносок
событие: события
совместно: совместно
совместный: совместную
современный: современного
содержание: содержание
создать: создать
сообщество: сообщество
сообщить: сообщить
состояться: состоялись
сохранение: сохранением
сохранить: сохранил
союз: союза
список: списка
справка: справка
среди: среди
ссылка: ссылка ссылками ссылки
стамп: стампе
статистика: статистика
статья: статьи статья
стеклянный: стеклянном
стиль: стиль
страна: страна
страница: страница странице страницу страницы
сын: сына
сюда: сюда
такой: такие
творчество: творчество
текст: текст
текущий: текущие
тематический: тематические
товарный: товарный
тони: тони
точный: точные
удалить: удалите
уезжать: уезжает уезжают
указание: указанием указания
указать: указан
улучшение: улучшения
умерший: умершие
универсальный: универсальная
университет: университета
урок: уроки
условие: условий условия
устранить: устранены
участвовать: участвует
участие: участие
учитель: учителей
учиться: учатся
учёба: учёба
учётный: учётную
ф: ф
фамилия: фамилией
февраль: февраля
феликс: феликсом
фердинанд: фердинандом
флёрить: флёри
фон: фон
фонд: фонд
форум: форум
хакль: хакль
ходлер: ходлером
ходлера: ходлер
хорватский: хорватская
художественный: художественная художественном художественный
художество: художеств
художник: художник художника художники художников художником художнику
цвет: цвету
цитировать: цитировать
цюрихский: цюрихском
человек: людях
чиновник: чиновника
читать: читать
член: член
шаблон: шаблон шаблонами
швейцария: швейцарии швейцария
швейцарский: швейцарский швейцарским швейцарского
э: э
экспорт: экспорт
элемент: элемент
эмиль: эмиля
энергичный: энергичными
энциклопедия: энциклопедии
это: этим
этот: эта
язык: язык языках
