аба: аба
абасович: абасович
август: августа
авсаджан: авсаджанов
авторство: авторства
александр: александр
алфавит: алфавиту
аманда: аманды
аманди: аманди
архивировать: архивировано
архивный: архивная
асср: асср
асуханов: асуханов асуханову
асухой: асуха
ахмед: ахмедов
бекичев: бекичев
бернгард: бернгард
биография: биография
бойцов: бойцова
борщёв: борщёв
валентин: валентин
вахит: вахит
вд: вд
век: века
венгрия: венгрии
версия: версия
викидать: викиданных
викимедиа: викимедиа
википедия: википедии википедия
виктор: виктор
вклад: вклад
война: войны
войти: войти
впечатление: впечатления
всероссийский: всероссийских
всесоюзный: всесоюзных
выпускник: выпускники
выставка: выставок
г: г
гайдукова: гайдукова
георгий: георгий
герман: герман
глава: главы
год: года году годы лет
государственный: государственными
гражданство: гражданство
грозный: грозного
дагестан: дагестан
дагестанский: дагестанского дагестанское
дата: дата
действовать: действовать
деятель: деятели деятель
деятельность: деятельности
джемал: джемала
дополнительный: дополнительные
доступный: доступен
другой: других
елена: елена
ещё: ещё
жизнь: жизни
заглавный: заглавная
запись: запись
зарегистрировать: зарегистрированный
заслуга: заслуги
заслужить: заслуженные заслуженный
заявление: заявление
звание: звания
знак: знак
зональный: зональных
иван: иван
избранный: избранные
изобразительный: изобразительное
имя: имени имён
ингушский: ингушская ингушской
индия: индии
инструмент: инструменты
иордания: иордании
иосиф: иосиф
искусство: искусств искусство
использование: использования
использовать: использующие
история: история
источник: источник источниками
июнь: июня
карагандинский: карагандинском
картина: картинах картины
категория: категории
каток: катков
код: код
кодекс: кодекс
коллекция: коллекциях
коновый: конов
конфиденциальность: конфиденциальности
копия: копия
короткий: короткий
кук: куки
ланка: ланке
лицензия: лицензии
лысенковы: лысенков
м: м
мама: мамы
мамиловый: мамилов
материал: материал
медаль: медалью
международный: международных
место: место
мир: мира
многий: многих
мобильный: мобильная
момент: момента
мордовин: мордовин
мочь: могут
музей: музее
мы: нами
н: н
навигация: навигации навигация
награда: наградами
наградить: награждён награждённые
награждение: награждении
найти: нашёл
народный: народные народный
находиться: находятся
некоммерческий: некоммерческой
неопр: неопр
новиков: новиков
новый: нов новые
нохчийна: нохчийн
обострение: обострения
обращение: обращения
обсуждение: обсуждение
окончание: окончания
окончить: окончил
октябрь: октября
описание: описание
организация: организации
основа: основой
оставаться: оставался
ответственность: ответственности
отдельный: отдельных
отказ: отказ
отражение: отражение
отредактировать: отредактирована
ошибка: ошибке
перейти: перейти
период: период
персоналия: персоналии
персональный: персональные
печать: печати печать
побывать: побывал
поведение: поведения
подробный: подробнее
поездка: поездок
пожертвовать: пожертвовать
поиск: поиск поиску
политика: политика
получить: получить
последний: последний
постоянный: постоянная
править: править
правка: правки
председатель: председатели
представиться: представились
президент: президента
примечание: примечания
проект: проектах
просмотр: просмотры
пространство: пространства
путешествовать: путешествовал
пётр: пётр
работа: работ работы
работать: работал
разработчик: разработчики
рана: раны
расширение: расширение
региональный: региональных
республика: республике республики республикой
республиканский: республиканских
родиться: род родившиеся родился
рождение: рождения
российский: российский российской
россия: россии россия
рсфср: рсфср
рубеж: рубежом
руслан: руслан
русский: русский
сальман: сальман
сафронов: сафронов
сачко: сачко
сведение: сведения
свежий: свежие
свободный: свободной
свой: своей
связанный: связанные
связаться: свяжитесь
сентябрь: сентября
система: системе
ситуация: ситуации
скачать: скачать
скрытый: скрытые
служебный: служебные
случай: случаях
случайный: случайная
смерть: смерти
смотреть: см
событие: события
советский: советский
сович: сович
содержание: содержание
создать: создать
сообщество: сообщество
сообщить: сообщить
сохранение: сохранением
союз: союза союзе
справка: справка
ссср: ссср
ссылка: ссылка ссылки
статистика: статистика
стать: стал
статья: статьи статья
страница: страница странице страницу страницы
сюда: сюда
так: т
творчество: творчестве
текст: текст
текущий: текущие
товарный: товарный
турция: турции
указ: указ
указание: указанием
улица: улица
умарсултан: умарсултанов
умерший: умершие
условие: условий условия
участие: участие
участник: участник
училище: училища училище
учёба: учёба
учётный: учётную
февраль: февраля
федерация: федерации
филипп: филипп
фонд: фонд
форум: форум
хамур: хамур
храниться: хранились
художественный: художественного художественное
художник: художник художника художники художников
центр: центр
цитировать: цитировать
частность: частности
частный: частных
чехословакия: чехословакии
чеченский: чеченский чеченского чеченское чеченской
чечня: чечне чечни
чечь: чечено
читать: читать
член: член членом члены
шри: шри
эдгар: эдгар
экспорт: экспорт
элемент: элемент
энциклопедия: энциклопедии
этот: эта
язык: языках
