автор: автор
авторство: авторства
адамкович: адамкович
азиляна: азилян
академия: академии
александров: александров александрова александровой
алмаз: алмазов
алфавит: алфавиту
ангел: ангел
андреев: андреев
андронов: андроновым
античный: античная
апрель: апреля
арт: арте
архивировать: архивировано
архитектор: архитектор архитекторы
архитектура: архитектура архитектуре архитектуру архитектуры
архитектурный: архитектурно
асклепий: асклепий
асср: асср
астафьев: астафьев
атом: атом
атрибут: атрибуты
б: б
банкетный: банкетном
бар: бар
баранов: баранов
басманный: басманной
башенный: башенные
башкирский: башкирскую
белопольский: белопольский
бетон: бетон
биеннале: биеннале
биография: биография
бирштейн: бирштейна
богданов: богданов
бой: боях
больница: больницы
брак: браке
бронза: бронза
будапешт: будапешт
будущее: будущее
бурштын: бурштыне
бывший: бывшего
былинкин: былинкин
быть: е
варшава: варшава
васнецов: васнецовым
вднх: вднх
век: вв века
великанов: великанов
вельможа: вельмож
венгерский: венгерская
венеция: венеция
вернадский: вернадского
верндский: верндского
версия: версии версия
веселие: веселье
весенний: весенняя
вестибюль: вестибюле
ветровый: ветровой
взаимопроникновение: взаимопроникновение
викидать: викиданных
викимедиа: викимедиа
википедия: википедии википедия
виллани: виллани
виноградский: виноградский
вклад: вклад
владимир: владимир владимире
владимирович: владимирович владимировна
владимировчить: владимировчи
власть: власти
влксм: влксм
внук: внуки
внутренний: внутреннем
войти: войти
волгодонск: волгодонск волгодонске
вологда: вологде
вологодский: вологодского
воронёный: вороненая
воссоздание: воссоздание
воссоздать: воссоздавших
время: времени время
всероссийский: всероссийская
всесоюзный: всесоюзная
вступительный: вступительной
вулый: вулых
вход: входа
входной: входных
выполнить: выполненная выполнены
выпускник: выпускники
высокий: высшем
выставка: выставка выставки выставок
вьетнам: вьетнам
вьетнамский: вьетнамским вьетнамского
г: г
газорезка: газорезка
галерея: галереи галерея
гальванопластика: гальванопластика
гейнельт: гейнельт
геолог: геолог геолога
гимнаст: гимнасты
гипс: гипс
главное: главного
глазырин: глазырин
год: гг год года годах году лет
горельеф: горельеф горельефов горельефы
горельефный: горельефная
горлышек: горлышков
горький: горького
госкаталог: госкаталог
гостиница: гостиницы
гостиничный: гостиничной
государственный: государственная государственного государственной
гражданство: гражданство
гранит: гранит
график: график
графический: графический
гриб: грибов
гусляр: гусляр
давид: давид
давиденко: давиденко
давыдов: давыдов давыдова
дата: дата
дверь: дверей двери
двор: двора
дворец: дворец дворца
дворик: дворике
действительный: действительные действительный действительным
действовать: действовать
декабрь: декабря
декоративный: декоративная декоративное декоративные декоративный
дело: делами
дель: дель
день: дне дня
дерево: дерево
детский: детского детской
деятель: деятели
деятельность: деятельности
диалог: диалог
дизайнер: дизайнер
диккенс: диккенса
дл: дл
дмитриевич: дмитриевна дмитриевной
дмитрий: дмитрий
добавить: добавить
добросердов: добросердова добросердовой
дойник: дойников
долгопрудненский: долгопрудненском
доломит: доломит
дом: доме
дон: дон дону
дополнительный: дополнительные
дореволюционный: дореволюционного
доска: доска доски
доступный: доступен
драма: драмы
драматический: драматического
дрессированный: дрессированная
другой: других
дсп: дсп
дубовицкий: дубовицкая
егерёв: егерев
единый: единый
ещё: ещё
её: её
жена: жена
живописно: живописно
жонглёр: жонглеры
з: з
заглавный: заглавная
закончить: закончил
зал: зала зале
залка: залка
занятие: занятий
западный: западный
записка: записок
запись: запись
зарегистрировать: зарегистрированный
зарубежье: зарубежья
заслужить: заслуженные заслуженный заслуженным
затем: затем
заявление: заявление
здание: здание здании здания
здоровье: здоровье
зеленоград: зеленограде
знак: знак
значение: значение
значительно: значительно
золотой: золотая
иван: иван
иванов: иванова
избранный: избранные
избрать: избран
известняк: известняк
изображение: изображений
изобразительный: изобразительного изобразительных
иллюстратор: иллюстратор
имо: имо
имя: имени имён
индустрия: индустрия
инженер: инженер инженеров
институт: института
инструмент: инструменты
инсценировка: инсценировка
интерьер: интерьера интерьере
интурист: интурист
ирина: ирина ириной
исакович: исакович
искатель: искатели
искусство: искусств искусства
исперия: исперии
использование: использования
история: история
источник: источник
июль: июля
июнь: июня
кавалер: кавалеры
казанский: казанским
казань: казань
каменский: каменский
камин: камина
кармена: кармен
картина: картины
картинный: картинной
каталог: каталог
категория: категории
кирилл: кирилл
кириллович: кириллович
кладбище: кладбище
клинический: клинической
клоун: клоун
клуб: клуб клуба
клыковый: клыковым
книга: книга
кованый: кованая
код: код
кодекс: кодекс
колесо: колесах
колхозник: колхозники
комедия: комедия
комиссия: комиссии
коммунизм: коммунизм
комплекс: комплекса
композиция: композиции композиций композиция
конкурсный: конкурсный
конфиденциальность: конфиденциальности
концертный: концертного
короткий: короткий
корреспондент: корреспондент корреспондентом
косаржевский: косаржевский
костин: костина
котельнический: котельнической
кпсс: кпсс
красильников: красильников
крупский: крупской
кубасовый: кубасов
кук: куки
культура: культуры
л: л
ландау: ландау
латунь: латунь
лауреат: лауреат лауреаты
лев: лев
ленин: ленина
ленинград: ленинград
ленинский: ленинской
летие: летию
листовой: листовая
литература: литература
лицензия: лицензии
лондон: лондоне
лошадь: лошадь
луначарский: луначарского
лутиковый: лутикова
людмила: людмила
м: м
мавзолей: мавзолее мавзолея
май: мая
макет: макет
малый: малых
мария: мария
март: марта
маска: маски
мастер: мастера
материал: материал
мать: мать
матэ: матэ
мгхп: мгхпа
медаль: медалью
медвежий: медвежий
медицина: медицина медицины
медицинский: медицинского
медь: медь
международный: международная международное международной
мемориальный: мемориальная мемориальные
место: место
мила: мила
мим: мим
мина: мина
министр: министров
мирный: мирный
мировой: мировой
михаил: михаил
михалёв: михалев
многофигурный: многофигурная
мобильный: мобильная
модель: модель
мозаика: мозаика
молодой: молодые молодых
монреаль: монреаль
монумент: монумент
монументалист: монументалист
монументальный: монументальная монументальный
морской: морской
москва: москва москве москвы
московский: московская московские московских московского московской московском
мосха: мосха
мотовиловый: мотовилов
мочь: могут
мрамор: мраморы
музей: музей
музыка: музыка
музыкальный: музыкального
мхат: мхат
мы: нами
н: н
набережная: набережной
навигация: навигации навигация
наводка: наводка
награда: награды
наградить: награжден
надежда: надежда надеждой
народный: народная
настенный: настенная
наш: наша
неизвестный: неизвестными
некоммерческий: некоммерческой
неопр: неопр
неосуществлённый: неосуществленного неосуществленный
непустой: непустое
нержавеющий: нержавеющая
нефтяник: нефтяников
никонов: никоновы
нина: нина
новиков: новиков
новый: нового новой новые новых
ноябрь: ноября
область: области
образ: образы
обращение: обращения
обсуждение: обсуждение
объединение: объединения
озеленение: озеленение
океан: океан
октябрь: октября
омский: омская
описание: описание
опытный: опытными
организация: организации организация
орден: ордена орденом
оренбург: оренбург
оригинал: оригинала
орлов: орлов
осенний: осенняя
основный: основных
остальной: остальные
осуществить: осуществлен
ответственность: ответственности
отдельный: отдельных
отец: отец
отказ: отказ
отличаться: отличаться
отличие: отличием
отредактировать: отредактирована
официальный: официальный
оформление: оформление оформления
ошибка: ошибке
павел: павел
павильон: павильон павильона
памятник: памятник
памятный: памятной
пантомима: пантомима
параметр: параметрами
париж: париж
пасть: павшим
первый: первая
передавать: передает
переехать: переехал
перейти: перейти
пермский: пермская пермского
персона: персона
персонаж: персонажи
персоналия: персоналии
персональный: персональные
перуцкой: перуцкого
петрушечник: петрушечники
петух: петух
печать: печати печать
пиквикский: пиквикский
пиквиксуий: пиквиксуого
пионер: пионеров
плакета: плакеты
поведение: поведения
повествовательность: повествовательности
подмосковье: подмосковье
подробный: подробнее
пожертвовать: пожертвовать
поиск: поиск поиску
пока: пока
показывать: показывают
покровский: покровский
полированний: полировання
полировать: полированная
политика: политика
получить: получить
портал: портал порталы
портик: портике
портрет: портрет
посвятить: посвященная
последний: последний
посмертный: посмертных
посохин: посохин
постановка: постановок
постоянный: постоянная
поступление: поступлений
похоронить: похороненные
похоронный: похоронен
почему: почему
править: править
правка: правки правок
правление: правлении правления
православный: православной
представиться: представились
президент: президента
премия: премией премии премий
преподаватель: преподавателями
преподобный: преподобного
примечание: примечания
принять: принят
приют: приюта
проблема: проблемы
проверить: проверенной
проверка: проверки
проверяться: проверялась
проект: проект проекта проектах
произведение: произведений
прометей: прометей
промышленный: промышленном
просмотр: просмотры
проспект: проспекте
пространство: пространства
профессиональный: профессиональных
профсоюз: профсоюзов
прп: прп
птицеводство: птицеводство
пушковый: пушкова
р: р
работа: работы
рабочий: рабочая
радонежский: радонежского
разработка: разработку
разработчик: разработчики
райисполком: райисполкома
ранинский: ранинский
рах: рах
ребёнок: детей дети
реестр: реестр
рельеф: рельеф
республика: республик республика
республиканский: республиканская
ресторан: ресторана
рига: рига
рк: рк
родина: родина родину родины
родиться: род родившиеся родился
родный: родной
рождение: рождения
роспись: роспись
российский: российский российской
россия: россии россия
ростов: ростове
рсфср: рсфср
русский: русские русский русского русское русской
рф: рф
рыдаев: рыдаев
сад: сад
сайт: сайт
саратов: саратове
саркофаг: саркофага
сварка: сварка
сведение: сведения
свежий: свежие
светлана: светлана
светлый: светлое
свободный: свободной
свой: свои
связанный: связанные
связаться: свяжитесь
семья: семье семья
сентябрь: сентября
сергеевич: сергеевна сергеевной
сергий: сергия
серебряный: серебряной
сестра: сестры
сидеть: сидящая
символ: символы
симонович: симонович
система: системе
скачать: скачать
скомароха: скомарохи
скончаться: скончался
скрипач: скрипач
скрытый: скрытые
скульптор: скульптор скульпторов скульпторы
скульптура: скульптура скульптуре скульптуры
скульптурный: скульптурная скульптурно скульптурное скульптурной скульптурные скульптурный
слава: слава
слонимский: слонимский
служебный: служебные
случай: случаях
случайный: случайная
смерть: смерти
смотреть: см
соавторство: соавторстве
собачка: собачкой
собрание: собрании
событие: события
совет: совета
советский: советская советский советских советского советской советскую
современный: современная современной
содержание: содержание
создание: создании
создать: создать
соколов: соколовой
солнцезащитный: солнцезащитная
соломатский: соломатский
соломон: соломону
сообщество: сообщество
сообщить: сообщить
сохранение: сохранением
сохраниться: сохранился
социалистический: социалистическая
союз: союз союза
спаситель: спасителя
спектакль: спектаклей
специальность: специальности
список: список
справка: справка
средневековый: средневековая
ссср: ссср
ссылка: ссылка ссылки
сталь: сталь
станковый: станковой
статистика: статистика
статуя: статуи
стать: стал
статья: статьи статья
стекло: стекло
степень: степени
стефанов: стефанова
стража: стражи
страна: стране
страница: страница странице страницу страницы
строганов: строганова
строгановский: строгановское
строительство: строительство
строить: строим
стройка: стройках
сувенир: сувенир
суздаль: суздале
сцена: сцены
съезд: съезду
сюда: сюда
так: т
танеев: танеевых
татарский: татарской
таёжный: таежных
театр: театра
театральный: театральные театральных
текст: текст
текущий: текущая текущие
тема: тему
тип: тип
тихий: тихий
товарный: товарный
ток: току
тонировать: тонированный
торговля: торговли
трагедия: трагедия
требовать: требуют
третьяковский: третьяковская третьяковской
труд: труда труду
туристический: туристического
тяжёлый: тяжелая
убранство: убранство
удостоить: удостоен
указание: указанием
улица: улице
ульяновск: ульяновске
умерший: умершие
управление: управления
условие: условий условия
установленный: установленная
участие: участие
участник: участниками
училище: училище
учиться: учился
учётный: учётную
ф: ф
файнштейн: файнштейн файнштейна
фальк: фалька
фамилия: фамилией
фарфор: фарфор
фасад: фасад фасада фасаде
февраль: февраля
федерация: федерации
федот: федотов
фигура: фигур
филлипович: филлипович
флагшток: флагштоки
флора: флора
фойе: фойе
фонарь: фонарей фонарь
фонд: фонд
фонтанный: фонтанная
форма: форм
форум: форум
фриз: фриз
фрунзе: фрунзе
х: х
хазанов: хазанова
ханой: ханое
хо: хо
холл: холла холле
храм: храма
христос: христа
хромовый: хромовая
художественно: художественно
художественный: художественная художественной
художество: художеств
художник: художник художники художников художником
цветной: цветные
цветоводство: цветоводство
цветок: цветы
цвилинга: цвилинга
центр: центра
церковь: церкви
цимлянск: цимлянска
цирк: цирк цирка
цитировать: цитировать
цыган: цыган
ч: ч
часть: части
часы: часы
чебоксары: чебоксары
человек: людях человек
челябинск: челябинск челябинске
чернов: черновым
чертёж: чертежи
чехов: чехова
читать: читать
член: член членом члены
чувашский: чувашская чувашские
чугун: чугун
шаблон: шаблон шаблона
шебалин: шебалина
шестой: шестом
ши: ши
шир: шир
школа: школе
школьник: школьников
шульц: шульц
эвакуировать: эвакуирована
эквалибрист: эквалибристы
экспо: экспо
экспорт: экспорт
элемент: элемент элементы
эльконин: элькониным
эмблема: эмблема эмблемами
энергетик: энергетиков
энциклопедия: энциклопедии
эрмитаж: эрмитаж
эскиз: эскизы
этот: эта
ю: ю
юриевич: юрьевич юрьевна
юрий: юрий юрия
яблонской: яблонская
язык: языках
якутия: якутия
якутск: якутске
якутский: якутского
январь: января
