август: августа августе
автор: автор
авторитет: авторитет
авторство: авторства авторство
академизм: академизм
академист: академистов
академический: академическая академических академического академической академическому
академия: академией академии академию академия
акафист: акафист акафиста
активно: активно
александр: александром
александровский: александровской
алексей: алексеем алексей алексея
алексий: алексия
алимпий: алимпию
алипий: алипием алипии алипий алипию алипия
алтарь: алтаре
алфавит: алфавиту
анализ: анализа
анатолий: анатолий
англ: англ
английский: английские
анджелико: анджелико
андреев: андреева
анонимный: анонимный
ансамбль: ансамбли
апостол: апостолов
апсида: апсиде
арсений: арсения
архангел: архангела
архив: архив архиве
архивировать: архивировано
архиепископ: архиепископ
архимандрит: архимандрита
архип: архипом
архипелаг: архипелага
архитектура: архитектуры
архитектурный: архитектурно
аскетизм: аскетизма
аспект: аспект
ассоциативный: ассоциативно
атрибуция: атрибуцию
балка: балку
бахтиаров: бахтиаров
бедствие: бедствия
безмолвие: безмолвии
беловолов: беловолов беловолова беловолову
берташа: берташ
бесплотный: бесплотных
бесстрастность: бесстрастность
библиотека: библиотека
биограф: биограф биографа
биография: биографии биография
биться: бьётся
благодаря: благодаря
благодать: благодати
благословлять: благословляет
бледный: бледным
близкий: близкое
бог: бога
богданов: богданов
богоматерь: богоматери богоматерь
богомолец: богомольцами
богомолье: богомолье
богомыслие: богомыслия
богородица: богородица богородице богородицы
богословие: богословия
божественный: божественной
божий: божией божьей божью
большаков: большакова
больший: большая большей
большинство: большинство
большой: большое
бондаренко: бондаренко
брат: брат брата
братия: братией братии братия
братский: братское братском
будущий: будущий будущих
бумага: бумагах
бусев: бусева
бывший: бывший
бытие: бытия
быть: будучи е
важный: важными
валаам: валаам валаама валааме валааму
валаамский: валаамская валаамские валаамский валаамским валаамскими валаамских валаамского валаамской валаамском валаамскому валаамскую
валаамския: валаамския
варфоломей: варфоломей
василий: василий василия
васильев: васильевой
васильевский: васильевском
вблизи: вблизи
вдохновение: вдохновения
вдохновитель: вдохновителем
ведяничев: ведяничев
век: века веков
великий: великая великий великого
великое: великое
вернуться: вернулся вернуться
вероятность: вероятности
вероятный: вероятнее
версия: версии версия
верхний: верхнего верхней верхнем
верховный: верховным
вестник: вестник
весь: весь всей всем всеми
весьма: весьма
ветхозаветный: ветхозаветная
вечеря: вечеря
вечность: вечности
вечный: вечное вечную
вид: виде
видеть: видел видеть
византийский: византийским византийского византийской
викидать: викиданных
викимедиа: викимедиа
википедия: википедии википедия
викисклад: викисклад викискладе
виктор: виктор
вклад: вклад
владычица: владычице
влажность: влажности
влияние: влияние влиянии влияния
вложить: вложена
вневременность: вневременность
внешний: внешнюю
внимание: внимание
внутренний: внутренний
внутренность: внутренность
возведение: возведению
возвратить: возвращена возвращены
возглавлять: возглавлял
возжжение: возжжение
возможность: возможность
возможный: возможным
вознесение: вознесение
возникновение: возникновение
возникнуть: возник
возраст: возрасте
война: войну
войти: войти вошёл
волос: волосы
волшебный: волшебные
вольнослушатель: вольнослушателем
воодушевление: воодушевление
вопрос: вопросы
воск: воск
воско: воско
воскресение: воскресение
воспитанник: воспитанника воспитанниками
воспоминание: воспоминания
воспринимать: воспринимал
восстановить: восстановил
вотще: вотще
впервые: впервые
впечатление: впечатление впечатления
впечатлительный: впечатлительный
вписываться: вписываются
временный: временный
время: временем времени время
вседержитель: вседержитель вседержителя
встретиться: встретился
встречаться: встречался
вступление: вступления
второй: второй втором вторую
входить: входило входит
выборгский: выборгская
выделение: выделение
вызывать: вызывает
выйти: вышедшей
вынудить: вынужден
вып: вып
выписывать: выписывали
выполнить: выполнен выполненные выполнены
выполнять: выполнявших выполнял
выполняться: выполнялась
выпускник: выпускники
выработаться: выработается
выражать: выражал
выразительный: выразительное
выразить: выразил выразить
высечь: высечена
высказываться: высказывалось
высокий: высокий высоком высшим
высоко: высоко
выставка: выставке выставок
выступать: выступают
выявить: выявленные выявлено
г: г
гавриил: гавриил гавриила гавриилом
гавриленко: гавриленко
галерея: галерея
генералов: генералова
геннадий: геннадий геннадия
гербек: гербек
герман: германа
гипсовый: гипсового
глава: главе главой главы
главное: главного главное
главнокомандующий: главнокомандующим
главный: главный
глаз: глаза глазами
гласить: гласит
глубина: глубины
глубокий: глубокого глубокое
говорить: говорят
год: год года годах годов годом году годы лет
годовщина: годовщиной
голова: голове
горбачёв: горбачёва
город: город
гос: гос
господень: господень
господин: господа
господний: господне
господь: господе господь
гравёр: гравёра
гранитный: гранитное
грань: гранью
гребень: гребнем
громадный: громадным
громогласный: громогласные
грудь: груди
грунт: грунта
группа: групп группы
грустный: грустные грустными
губерния: губернии губернию губерния
давать: давала даёт
давыдов: давыдова
далее: д
дамиан: дамиан дамиана
данченко: данченко
даровать: даровал
дарственный: дарственной
дата: дата дату даты
датировать: датированные датировать
датировка: датировку
дать: данная
два: две двух
дважды: дважды
двенадцать: двенадцать
движение: движений движения
двор: двором
девый: дево
деисус: деисус
действие: действие действием действия
действительно: действительно
действительность: действительности
действовать: действовать действующих
декабрь: декабрь
делать: делал
дело: дело
день: день дня
деревня: деревне
дерево: дереве
деревянный: деревянную
держава: державу
держать: держащей держит
десить: десь
деталь: деталях
деятельность: деятельности деятельность деятельностью
диалог: диалога
дисса: дисс
диссертация: диссертации
дисциплина: дисциплины
длительный: длительное
дмитриев: дмитриев
дневник: дневнике
дневниковый: дневниковых
добавить: добавить
добрый: добрыми
догматический: догматическое
дойти: дошли дошло
доктор: доктор
документ: документа документах документов документу документы
долго: долго
доп: доп
дополнительный: дополнительные
допускать: допускает допускал
досадный: досадно
досифей: досифея
достигнуть: достигнута
достоверный: достоверных
достоинство: достоинства
доступный: доступен
драматург: драматург
древний: древние
другой: другие другими других другого другому
духовность: духовности
духовный: духовной духовную духовным
душа: душа душу
егда: егда
елизавета: елизавета елизаветы
ещё: ещё
её: её
жанр: жанр
желание: желание
желать: желать
женственный: женственную
жест: жесты
живой: жив живая живое
живописец: живописца живописце живописцев
живописный: живописного
живопись: живописи живопись
живоподобие: живоподобие
жизнь: жизни жизнь жизнью
жительница: жительница
журнал: журнал журнале
журналист: журналист
жёсткий: жёсткие
забросить: заброшенной
забытый: забыта
забыть: забудьте
заглавный: заглавная
заглохнуть: заглохнет
задаток: задатки
задний: заднему
задумывать: задумывает
задушевный: задушевное
закончить: закончил
закхей: закхей
заметить: заметила
заметка: заметки
замечать: замечала
замысел: замысел замысла
заниматься: занимаясь
занятый: занята
запад: западу
западноевропейский: западноевропейские
запись: запись записях
заполнить: заполнить
зарегистрировать: зарегистрированный
зарубежье: зарубежье
зарянко: зарянко
заслуга: заслугой
застать: застал
затем: затем
заторопиться: заторопился
затруднять: затрудняет
захоронение: захоронения
захотеть: захотел
зачислить: зачислен
заявление: заявление
здоровье: здоровьем здоровья
земля: земле
земной: земной земными
знак: знак знаком
знаменитый: знаменитой
знание: знание
значение: значение
значительный: значительное
золотистый: золотистые
золото: золотом золоту
золотой: золотой золотых
золочение: золочением
золочёный: золочёные
зрение: зрения
зритель: зритель
иван: иван иваном
иванов: иванова ивановым
иванович: иванович ивановича
играть: играть
игумен: игумен игумена игумене игуменом
идеал: идеалу
идти: идёт
иеродиакон: иеродиакона иеродиаконы
иеромонах: иеромонах иеромонаха иеромонахи иеромонахом
иждивение: иждивением
избивать: избивали
избранный: избранные избранных
известно: известно
известность: известность
известный: известная известного известной известным
извод: извода
изд: изд
издание: издание издания
издательство: издательство
изменить: изменён
измениться: изменился изменится
изменяться: изменяющегося
измученный: измученным
изображаться: изображается
изображение: изображение изображения изображениями
изобразительный: изобразительному
изобразить: изображена изображены
иисус: иисуса иисусом
икона: икон икона иконами иконах иконе иконой икону иконы
иконографический: иконографическими иконографического иконографическому
иконография: иконографии иконографию иконография
иконология: иконологии
иконописец: иконописец иконописца иконописце иконописцев иконописцем иконописцу иконописцы
иконописный: иконописная иконописного иконописной иконописному иконописную иконописным
иконопись: иконописи иконопись иконописью
иконостас: иконостас иконостаса иконостасе иконостасов
илл: илл
иллюстрация: иллюстрации иллюстрациях
илья: ильи
именно: именно
именовать: именуемого
иметь: имеет имеют
император: императором
императорский: императорская императорским императорской императорскую
императрица: императрицей
империя: империи империя
имя: именами именем имени имя имён
инок: инок иноками иноков
иноческий: иноческую
институт: институт
инструмент: инструменты
интерес: интерес
интернет: интернет
интерьер: интерьеров
иоанн: иоанном
ионафан: ионафан ионафана ионафане
иордан: иордана
ирина: ирина ириной
искать: ищет
исключительно: исключительно
искусный: искусный
искусство: искусства искусство искусству
искусствовед: искусствовед искусствоведов
искусствоведение: искусствоведения
искусствознание: искусствознания
исполнение: исполнение исполнению исполнения
исполнить: исполнить
исполнять: исполнявший исполнял
использование: использование использования
использовать: использующие
использоваться: использовались
испр: испр
испытывать: испытывал
исследование: исследований
исследователь: исследователей исследователи исследователями
исследовательница: исследовательница исследовательнице исследовательницы
исторический: исторический
история: истории история
источник: источник источники
исходить: исходя
исцеление: исцеление
июль: июля
июнь: июня
й: й
кажущийся: кажущимся
казначей: казначей
казённый: казённой
каменный: каменного
канд: канд
кандидат: кандидат
кандидатский: кандидатской
канон: каноном
канонический: канонических
капитал: капитал
карелия: карелия
картина: картину картины
категория: категории
качество: качестве
киево: киево
киот: киот
кисельков: киселькова
кисть: кисти
кладбище: кладбище
класс: класса
классика: классика
клеевой: клеевой
клей: клее клеем клей
книга: книге книги
книжный: книжная
княжество: княжество
князь: князь
код: код
кодекс: кодекс
кой: коему
колокол: колокол
колокольня: колокольне колокольней колокольни
колористика: колористике
колорит: колорит
комиссия: комиссии
комментарий: комментарии
комнином: комнином
композиция: композиции композиций композицию композиция
коневский: коневская
конец: конце концу
консервативно: консервативно
консистория: консисторию
константин: константин константина
константинов: константинов константинова константинову константиновым
константинополь: константинополе константинополь
контрастный: контрастный
конфиденциальность: конфиденциальности
конфликт: конфликт
кончина: кончины
копия: копию копия
короткий: короткий
корпелайнный: корпелайнен
костомаровский: костомаровскому костомаровскую
который: которая которого которое которой котором которую которые который которым которыми которых
краевед: краевед
край: краям
краска: красками краски красок
красота: красоту красоты
красочный: красочного красочный
краткий: краткая
крепиться: крепился
крест: крестом
крестьянский: крестьянское
кризис: кризис
кроме: кроме
круг: круг
кудри: кудрей
куинджи: куинджи
кук: куки
культура: культур культура
купол: купол куполе
куткова: кутковой
л: л
лампада: лампады
лащенко: лащенко
левкас: левкасу
левый: левой
легенда: легенды
леденить: леденит
лежать: лежит
лениздат: лениздат
лента: ленте
лентяй: лентяем
леонид: леонид
лес: лес лесами
лессировка: лессировками
лессировочный: лессировочная лессировочных
летие: летию
лето: летом
леушинский: леушинское
лик: лика ликах
лилия: лилий
линия: линии
липниковый: липниково
литература: литература
литография: литографии
литургический: литургическое
литургия: литургии
лицензия: лицензии
лицо: лиц лицо лицом
лично: лично
личность: личность
личный: личном
лишь: лишь
локальный: локальным
лоно: лоне
лук: луку
лука: лука луки
любовь: любви
лютеранин: лютеране
лютеранский: лютеранская лютеранского
лёгкий: лёгкой
м: м
мадонна: мадонны
май: мая
макаров: макаров
маленький: маленького
мало: мало
малый: малой малую
манер: манер
манера: манерой манеры
мантия: мантию
мария: марии
маркс: маркса
март: марта
масло: маслом
масляный: масляной
мастер: мастеров
мастерская: мастерская мастерских мастерской мастерскую
мастерство: мастерства мастерству
материал: материал
матрона: матроны
мать: матери матерь
махан: маханов
машков: машковым
мгновенный: мгновенное
медаль: медаль медалью
медиа: медиа
медиафайл: медиафайлы
меловой: мелового
мена: мене
мера: мере
местный: местная
место: место местом
месяц: месяц месяца месяце
метеорологический: метеорологических
метод: методом
метрический: метрической
мечтать: мечтал
мещанин: мещан мещанин мещанина
мещанский: мещанского мещанской
мир: мир мира миру
мировой: мировую
мирской: мирской
мистический: мистического мистическое
михаил: михаил
младенец: младенца младенцем
младший: младший
мнение: мнению
многое: многое
мобильный: мобильная
могила: могила могиле
могучий: могучей
мозаика: мозаику
молитва: молитвам молитвой
молитести: молитеся
молния: молния
молчание: молчанием
момент: моменту
монастырский: монастырского монастырской
монастырь: монастыре монастырей монастырь монастырю монастыря
монах: монах монаха монахами монахов монахом
монашеский: монашеской
монашество: монашество
монументальный: монументальная монументальных
морской: морскими
мочь: мог могут
мощь: мощью
мужицкий: мужицкая
музей: музея
мучиться: мучился
мы: нами
мысль: мысли мысль
мытарь: мытарь
мягкий: мягкий мягкое мягкому
мягкость: мягкость
мёд: мёд
н: н
набедренник: набедренником
наблюдать: наблюдает
набросок: набросок
навигация: навигации навигация
навык: навыки
награда: награда награду награды
наградить: награждён
надгробие: надгробие
надгробный: надгробная
надпись: надпись
название: название названий
назвать: назвал названный
назначить: назначенный
называть: называет называл называла называли называя
наиболее: наиболее
наивный: наивен
найти: найден найденного найти
накидка: накидкой
нанесение: нанесением
наноситься: наносилось
написание: написанию
написать: написал написана написанные
напоминать: напоминает
направить: направил направлены
направление: направления
нарисовать: нарисованы
наследие: наследия
настаивать: настаивает
настенный: настенные
настойчивый: настойчив
настоятель: настоятелем
настоящий: настоящее настоящему
наталья: наталья
натурщик: натурщика
наука: наук
научный: научных
находить: находило
находиться: находившиеся находилась находился находится
находка: находке
начало: начала начале начало
начальство: начальства начальству
начаться: началось
начинать: начинал
наш: нашего
небесновечный: небесновечной
небесный: небесно небесные небесных
небо: неба
недостаток: недостатки
недуг: недуга
нежели: нежели
нежный: нежные нежный
неземной: неземную
неизвестный: неизвестного неизвестный неизвестным
неистовый: неистовой
некий: некоей
некоммерческий: некоммерческой
некоторый: некоторое некоторые некоторых
некролог: некролог некролога
немалый: немалой
немирович: немирович немировича
необходимость: необходимостью
необходимый: необходимым
необыкновенно: необыкновенно
неоднозначный: неоднозначная
неопр: неопр
неподписанный: неподписанный
непостыдный: непостыдная
неприкосновенный: неприкосновенным
неравноценность: неравноценность
несколько: несколько
несмотря: несмотря
нести: несёт
нестор: нестор
нетленный: нетленное
нижний: нижнего нижней
никакой: никаким никаких никакое
никейский: никейским
никея: никее никею
николаевич: николаевич николаевича
николай: николай николая
никольский: никольского
никопея: никопеей никопея
новгородский: новгородской
новый: ново новом новые новый
нога: ног
ношение: ношения
нужда: нуждах
оба: обоих
обдумывать: обдумывал
обер: обер
обещать: обещавшего
обида: обидой
обидно: обидно
обитель: обитель
облако: облаке
обнаружить: обнаружил
образ: образ образа образом
образец: образцами образцов образцом образцы
образование: образования
обращение: обращение обращения
обрести: обрёл
обретение: обретении обретения
обсуждение: обсуждение
обувь: обуви
обуревать: обуреваемым
обучаться: обучался
обучение: обучение
обходить: обходит
общественный: общественной
общество: общества общество
общий: общего общем общими
объяснять: объясняла объясняют
объёмный: объёмного объёмный
обязанность: обязанности
огромный: огромной
огрубеть: огрубеют
одарённость: одарённости
одежда: одежд
одигитрия: одигитрия
один: одна одним одних одной
однако: однако
ожидать: ожидая
ожог: ожога
окно: окно
около: около
окончить: окончить
октябрь: октября
олма: олма
олонецкий: олонецкую
омылить: омыленный
он: нём
она: неё
онаний: онанию
они: ними
онуфрий: онуфрий
опасность: опасность
опираться: опиравшейся
описание: описание
описывать: описывал
опосредованно: опосредованно
определить: определён
определяться: определяются
опубликовать: опубликованный опубликованы
опыт: опыту
организация: организации
организовать: организована
оригинал: оригинала оригинале
оригинальный: оригинальный
орнамент: орнаментом орнаменты
орнаментальный: орнаментальным
осетровый: осетровый
основа: основе
основать: основан основана
особенно: особенно
особенность: особенности особенностям особенностями
особо: особо
особый: особому
оставаться: оставалась оставался
оставить: оставить
оставлять: оставляет оставлял
остальной: остальные
остаться: оставшимися
остров: остров острове
отв: отв
ответственность: ответственности
отдел: отделов
отделение: отделением
отделка: отделка
отделываться: отделывается
отдельный: отдельные отдельных
отец: отца отцы
отказ: отказ
отличать: отличает
отличаться: отличается
отметить: отмечены
отмечать: отмечает отмечал отмечала отмечают
относить: относит
относиться: относится
отозваться: отозвался
отойти: отошёл
отпечаток: отпечаток
отпроситься: отпросился
отражаться: отражались
отредактировать: отредактирована
отсутствие: отсутствие отсутствия
отход: отходе
отчий: отчего
официальный: официальный официальных
оформление: оформления
оценивать: оценивал
оценить: оценённым
очевидность: очевидностью
очередь: очередь
очерк: очерке очерки
очистилище: очистилище
ошибиться: ошибся
ошибка: ошибке ошибку
ошибочно: ошибочно
ощущать: ощущал
ощущаться: ощущается
п: п
павел: павла
палата: палаты
палец: пальцев
паломник: паломник
паломнический: паломнические
панагия: панагия
парный: парная
пастельный: пастельному пастельный
пастозный: пастозная
патриарх: патриарха
педагог: педагога
пейзажист: пейзажистом
первоначально: первоначально
первый: первого первое первую первых
перевод: переводе
переводчик: переводчик
передавать: передают
передача: передаче
передний: передний
перейти: перейти
переломный: переломным
переместить: перемещён
перенести: перенесён
перенять: перенят
переписка: переписки
пересказ: пересказ
переход: переход
персоналия: персоналии
персональный: персональные
петербург: петербурга петербурге
петербургский: петербургский петербургской
петрозаводск: петрозаводск петрозаводске
печать: печати печать
печерский: печерского
печёрина: печёрина
пешехон: пешехонов
пешехонов: пешехонова
пиетизм: пиетизм
писатель: писатель писателю
писать: писал писала писали писать пишет
письмо: писем письма
план: план плану
плита: плита
плотный: плотная
плохой: хуже
победоносцев: победоносцев победоносцева
победотворный: победотворной
поблёкнуть: поблёкнут
побывать: побывавший
поведение: поведения
поверхность: поверхность
повышенный: повышенной
погаснуть: погаснут
погибнуть: погибла
погребение: погребение
погрести: погребён
подарить: подарен
подать: подал
подвиг: подвиг
подвижник: подвижники
подворье: подворье
подданство: подданство
поддерживать: поддерживает
подмалёвка: подмалёвка
подобие: подобие
подобный: подобных
подписать: подписаны
подпись: подписью
подробный: подробнее
подростковый: подростковом
подчёркивать: подчёркивает
поездка: поездка поездки
пожаловать: пожалован
пожертвовать: пожертвовал пожертвовать
позавидовать: позавидовать
позволить: позволившие
поздний: позднем
познакомиться: познакомиться
поиск: поиск поиску
пока: пока
показать: показанную
покоиться: покоится
покойный: покойного
покраснеть: покраснел
покровитель: покровители
полемично: полемично
политика: политика
полка: полка
полный: полное полный
половина: половины
положение: положение
положить: положило
получение: получения
получить: получил получила получить
польза: пользу
пользоваться: пользовался
помалу: помалу
поместить: помещена помещён
поминовение: поминовения
помогать: помогающая
понимание: понимания
понятно: понятно
поощрительный: поощрительную
поощрять: поощряет
порабощение: порабощение
поражать: поражает
портрет: портрет
порядок: порядке
посещение: посещения
последний: последний последних
последующий: последующим последующими
послушание: послушание
послушник: послушников послушником
посмотреть: посмотреть
постижение: постижения
постоянно: постоянно
постоянный: постоянная
пострадать: пострадавших
постриг: постриг
постричь: пострижен
потрясти: потрясён
потускнеть: потускнела
почивший: почившего
почитание: почитание
почитать: почитаемой почитал
поэзия: поэзии
поэт: поэт
поэтому: поэтому
появление: появления
пояснить: пояснить
правда: правда
праведник: праведники
правильность: правильностью
править: править
правка: правки
православие: православие
православный: православная православной
правый: правая
праздник: праздника
празднование: празднование
прах: прах
преблагой: преблагая
превозмочь: превозмочь
предание: преданием
предварительно: предварительно
предполагать: предполагал предполагала
предположение: предположение
предположительно: предположительно
предположить: предположил предположила предположить
представитель: представитель
представиться: представились
предстательница: предстательнице
преимущественный: преимущественной
пренепорочный: пренепорочная
преображение: преображение
преображенский: преображенский преображенского преображенском
преобразовать: преобразовать
преподавание: преподавания
преподавать: преподававшего
преподобный: преподобного преподобных
пресвятой: пресвятой
пресвятый: пресвятыя
преходящий: преходящее
приблизиться: приблизиться
прибытие: прибытия
прибыть: прибыл
привлекать: привлекала
привлечь: привлекла
приглашать: приглашающий
пригород: пригородов
признаваться: признаётся
признаться: признался
прийти: пришёл
прикрывать: прикрывает
приложение: приложением
прим: прим
применять: применял
пример: примером
примечание: примечания
примириться: примирилась
принадлежать: принадлежат
принцип: принципы
принять: примет принял принят принято
приобщение: приобщения
приписывать: приписываемых приписывает приписывали
природа: природу природы
природный: природные
прислать: прислана
пристанище: пристанище
приступать: приступает
присудить: присуждена
присутствие: присутствии
причина: причин причиной
пришиб: пришиб
приём: приём приёмы
пробить: пробила
проблема: проблем проблема проблемы
проверить: проверенная
прогресс: прогресс
продолжение: продолжение
продукция: продукции
проект: проектах
проживать: проживающий
прозирание: прозиранием
произведение: произведении произведений произведения
производить: производят производящих
пройти: прошли
проказить: прокажённого
прокурор: прокурор
промазываться: промазывалась
просить: просил
просмотр: просмотры
простой: простой
пространство: пространства
просьба: просьбу
протекать: протекает
противопоставляться: противопоставляется
протоиерей: протоиерея
профессионализм: профессионализма
профессиональный: профессионального
проходить: проходил проходит
процент: проценты
прошедшее: прошедшее
прошение: прошение прошения
прошлое: прошлого
проявить: проявил
псковый: псково
пстгу: пстгу
публикация: публикации
публицист: публицист
пунический: пунический
пустынь: пустыни
путевой: путевые
путешественник: путешественник
путешествие: путешествий
пчелиный: пчелиный
пытаться: пытался
пятиярусный: пятиярусного
пятно: пятен
пётр: петра пётр
р: р
работа: работ работа работами работе работой работу работы
работать: работал работать
работоспособность: работоспособности
рабочий: рабочий
радоваться: радуйся
радонежский: радонежского
радост: радосте
развеваться: развевающиеся
развивающийся: развивающимся
развитие: развитии
развить: развить
раздел: раздела
различие: различии
размеренность: размеренность
разный: разных
разобрать: разберёшь
разработчик: разработчики
рака: ракой
ракурс: ракурсе
рамка: рамках
ранее: ранее
ранний: ранней раннем
расписывать: расписывает
распределение: распределение распределением
распространиться: распространившиеся
рассказ: рассказ рассказы
рассказывать: рассказывает
рассмотреть: рассмотрена
расширение: расширение
расщепить: расщепила
рафаэль: рафаэлем рафаэли рафаэля
реалия: реалиями
ред: ред
редкий: редкой
резник: резников
рекомендовать: рекомендовал
реконструировать: реконструировала
ректор: ректора
религиозный: религиозная
рельеф: рельефа рельефом
репин: репина
реставратор: реставратор
реставрация: реставрации
речь: речь
решение: решение
решительный: решителен
риза: ризы
ризница: ризница
рисунок: рисунка рисунков рисунок
робкий: робок
родитель: родителей родителями
родиться: род родившиеся родился
родный: родным родными
рожд: рожд
рождение: рождении рождения
рождество: рождество
роль: роль
романтический: романтической
роспись: росписей росписи роспись росписях
российский: российская российской
россия: россии россия
рост: рост
рубль: рублей
рука: рук рука рукой
руководитель: руководители руководителя
руководить: руководил
рукоположение: рукоположения
рукоположить: рукоположён
русс: руссы
русский: русский русского русское русской
русскоязычный: русскоязычного
рыбинск: рыбинск
рыбинский: рыбинский рыбинского рыбинской рыбинском
рыбкин: рыбкин
рывкина: рывкин
ряд: ряде
ряса: рясу
рясофор: рясофор
саваоф: саваоф
сайт: сайт
сам: самим самого самой
самостоятельный: самостоятельной
санкт: санкт
санти: санти
сборник: сборник
сведение: сведений сведения
свежий: свежие
свет: свет свете свету
светлана: светлана
светлый: светлый
светский: светские светской
свечение: свечением
свидание: свидания
свидетельство: свидетельством
свидетельствовать: свидетельствуют
свобода: свобода
свободный: свободной
свой: своего своей свои своих свой своём
свойственно: свойственно
свойство: свойство
связанный: связанной связанные связанных
связать: связан связана
связаться: свяжитесь
связующий: связующего
связывать: связывала связывали
связь: связи
святие: святии
святитель: святителей святителя
святой: святейшего свято святого святой святых
священный: священной
сгореть: сгорел
себя: собой
север: север
северо: северо
сезонный: сезонный
секрет: секрета
семинарист: семинаристам
семинария: семинарии
семья: семье
сентиментальность: сентиментальности
сентябрь: сентябре сентября
сергей: сергей
сергиев: сергиевой
сергий: сергия
серебряный: серебряной серебряную
середина: середине середины
серия: серия
сжать: сжал
сикстинский: сикстинской
сила: сил силами силу
сильный: сильного
символ: символ символом
символикий: символико
символический: символический
синод: синода
система: системе
сияние: сиянии
сказание: сказание сказания
сказать: сказать
скала: скалах
скачать: скачать
скит: скита скитах скитов
скитский: скитского скитскому
складка: складки складку складок
склонность: склонность
склонный: склонный
сконфузиться: сконфузился
сконч: сконч
скончаться: скончался
скорбеть: скорбящей скорбящим скорбящих
скоро: скоро
скромность: скромность
скрытый: скрытой скрытые
скульптура: скульптуры
скульптурность: скульптурность
скуфейка: скуфейку
словесность: словесность
словно: словно
сложный: сложное
слой: слой слоя слоями слоёв
служебный: служебные
служить: служили
случай: случаях
случайный: случайная
случевский: случевский
сменяться: сменяются
смерть: смерти
смешанный: смешанной
смирение: смирение
смоленск: смоленском
смоленский: смоленского смоленской
смотреть: см
смочь: смог
смысл: смысла
смысловой: смысловых
снизу: снизу
снова: снова
собор: собора соборе
соборн: соборне
соборный: соборного соборную
событие: событие событием события событиях
совершать: совершал совершать
совесть: совести
современник: современник современники современников
содействие: содействии
содержание: содержание содержания
соединять: соединяет
создание: создании создания
создатель: создатель
создать: создал создана созданные созданный созданных создать
сойкин: сойкина
соколов: соколова соколовой
сон: сном
сообщение: сообщение
сообщество: сообщество
сообщить: сообщить
соответствие: соответствии
соотношение: соотношении
сосновца: сосновец
состав: состав составе
составитель: составитель
составлять: составлял
состояние: состояние состоянию
состоять: состоял
сотня: сотни
сотрудник: сотрудниками
сотрудница: сотрудница
софия: софии
сохранение: сохранением
сохранить: сохрани сохранивший сохранил
сохраниться: сохранившихся сохранились сохранилось сохранился
сохранность: сохранности
сочетать: сочетал сочетающей
спаситель: спасителя
спасо: спасо
спасский: спасскому
спб: спб
спереди: спереди
специфика: специфику
список: списка списки список
спокойствие: спокойствие
спор: споры
спорный: спорным
справа: справа
справка: справка
сразу: сразу
среди: среди
средство: средств
сретение: сретение
срок: срок
ссылка: ссылка ссылки
стабильный: стабильная
стандартный: стандартную
становиться: становится
старое: старое
старый: старая старой старый
статистика: статистика
стать: став ставший стал стала стало статей
статья: статье статьи статья статьях
стена: стенах стены
степень: степень степенью
стиль: стиль стилю стиля
стихийный: стихийных
столетие: столетие
столетний: столетней
стопа: стопы
сторона: стороны
стоять: стоят
страдание: страданий
страница: страница странице страницу страницы
строгий: строгого
строительство: строительству
строиться: строящегося
студент: студента
судьба: судьба
суметь: сумел
сухой: сухой сухую
сухопутный: сухопутными
существовать: существовала
сущий: сущим
сходство: сходство
счастие: счастьем
счесть: счёл
считать: считает считал считала
считаться: считался
сын: сына
сюда: сюда
сюжет: сюжеты
сюжетный: сюжетной
тайна: тайны
тайный: тайная
так: т
также: также
такой: такая такими таких такого
талант: талант таланта
творческий: творческих творческой
творчество: творчества творчестве творчество творчеству
текст: текст
текущий: текущие
тема: тему
темпера: темперы
темперный: темперной темперными
тень: тени
теория: теории
техника: техника технике техники
тип: тип типа типами типом типу
типография: типография
ткань: ткани
товарный: товарный
том: томе
тональный: тонального
тонкий: тонким
торжественность: торжественность
тот: те
точка: точки точку
точно: точно
точный: точная точное
традиция: традицией
трактовка: трактовка
трапеза: трапезой
трапезная: трапезной
трепетность: трепетность
три: трёх
троеручица: троеручицы
троица: троица троице
трон: троне
труд: трудами
трудник: трудника
труженик: труженик
тщательность: тщательность
тщедушный: тщедушного
тысяча: тысячу
тёплый: тёплое
убо: убо
увезти: увезена
увенчать: увенчанную
увидеть: увиденных
увольнение: увольнении
угаснуть: угасшего
удаваться: удаётся
удаться: удалось
удерживать: удерживает
удивительный: удивительная удивительный
удовлетворить: удовлетворить
уединение: уединению
уезд: уезд уезда уезде
узкий: узкий
уйти: уйти ушёл
указ: указом
указание: указанием
указывать: указывая
указываться: указывается
укор: укорами
умереть: умер умрёт
умерший: умершем умершие
упоминание: упоминания
упоминать: упоминает
упоминаться: упоминается упоминался упоминаются
употреблять: употребляемы
управа: управы
управлять: управлявшим
усердный: усердный
условие: условий условия условиях
условный: условный
успение: успения
успенский: успенского успенской
установить: установила установлено
устойчивость: устойчивость
утверждать: утверждал утверждала утверждают
утверждение: утверждению
уточнять: уточняет
утратить: утрачены
уход: уход ухода
уходить: уходил
участие: участие участии
ученик: ученик учениками учеников учеником
учитель: учитель
учитывать: учитывая
учиться: учился
учёба: учёба
учётный: учётную
ф: ф
факт: факт
фамилия: фамилия фамилиями
феномен: феномены
фигура: фигур фигурах
фигурный: фигурного
филологический: филологических
философский: философских
финляндия: финляндии финляндию
финляндский: финляндское финляндской
финский: финская финские
фон: фон фоны
фонд: фонд фондах фонды
форум: форум
фотий: фотия
фотограф: фотограф
фотография: фотографии фотография
фра: фра
фрагмент: фрагмент
французский: французские
фреска: фресками фреску фресок
фресковый: фресковые фресковых
фёдор: фёдора
х: х
халкидон: халкидон
характер: характер
характерный: характерно характерные характерным
хитон: хитона
холст: холста
хороший: лучшего лучшим
хотеть: хотели
хотя: хотя
храм: храма храмах храме храмов храму
храмовый: храмовые
хранилище: хранилище
хранитель: хранитель
храниться: хранятся
христианский: христианского
христов: христово
христос: христа
хрупкость: хрупкость
художественный: художественная художественного художественной художественную
художество: художеств
художник: художник художника художниках художники художников
царственный: царственное
царство: царство
цветовой: цветового цветовых
целое: целом
центральный: центральный
церковный: церковная церковной церковному
церковь: церкви церковь
цировка: цировки
цитировать: цитировать цитирует
часовня: часовен часовне
частица: частица
частность: частности
часто: часто
часть: части часть
чеканка: чеканки
человек: людях человека
черта: чертами черты
честь: честь
четверть: четверти
четырёхъярусный: четырёхъярусным
число: число
чистота: чистоты
чистый: чистые
читатель: читателя
читать: читать
член: членом
чтение: чтения
чтить: чтивших чтимый
чувство: чувства
чудесный: чудесной
чудотворец: чудотворцев
чудотворный: чудотворная чудотворного чудотворной
шаблонный: шаблонный
шапка: шапкой
шевченко: шевченко
шишкин: шишкиным
школа: школа школе школой школу школы
шмелёв: шмелёв
штукатурка: штукатурке
щит: щит
э: э
эдесский: эдесский
экз: экз
экспонироваться: экспонируются
экспорт: экспорт
элемент: элемент элементы
эмалевидный: эмалевидная
энциклопедия: энциклопедии энциклопедия
эпизод: эпизодом
эталон: эталоном
это: этим это
этот: эта этими этих
этюд: этюд этюды
южный: южная
юность: юности
юноша: юноши
юный: юного юный
явление: явления
являться: являются
яже: яже
язык: языках языке
яркий: яркая ярче
ярославский: ярославская ярославской
