август: августа
австралия: австралия
автобиография: автобиография
автор: автор автора автором авторы
авторство: авторства авторству
агаян: агаян агаяна агаянов
агвалус: агвалуса
агентство: агентствами
азия: азии
айленд: айленд
аква: аква
алан: алан
алмансила: алмансил
алфавит: алфавиту
америка: америку
американский: американский
англ: англ
английский: английском
англия: англия
анджелес: анджелес
античный: античный
арвор: арворе
аризона: аризона
армия: армии
армянский: армянский
арт: арт арте
арутюнян: арутюнян арутюняну
архив: архив
архивировать: архивировано
архивный: архивной
асатурович: асатурович
ассоциация: ассоциация
атмосфера: атмосферу
аукцион: аукцион аукционе
африка: африки африку
бабушка: бабушка
база: базы
бенгстон: бенгстон
бенеттон: бенеттон
берген: берген
беррад: беррадо
библиографический: библиографической
библиотека: библиотека
библиотечный: библиотечных
бигга: бигги
биз: биз
билд: билд
биография: биографии биография
большой: большой большом
бостон: бостон
брансуик: брансуик
брат: брата
британский: британской
булавайо: булавайо
бумажный: бумажный
валя: вале
ванная: ванной
вашингтон: вашингтон
вднх: вднх
век: века
великобритания: великобритания
венгера: венгера
версия: версия
верхний: верхней
вестерос: вестерос
вестфолд: вестфолд
весь: всему
визуальный: визуального
викидать: викиданных
викимедиа: викимедиа
википедия: википедии википедия
вклад: вклад
включать: включающие
вновь: вновь
внук: внуков
возвращение: возвращения
возможность: возможность
войти: войти
вокруг: вокруг
волкер: волкер
вспомнить: вспомним
второй: вторая
входить: входит
вхутемас: вхутемаса
выпустить: выпустил
высокий: высшее
выставка: выставка выставках выставке выставки выставок
выставляться: выставлялся
выше: выше
г: г
газарасти: газарос
газароса: газароса
газета: газете
газетный: газетная
галерея: галереи галерея галереях
галерий: галерии
гамбьер: гамбьер
гарь: гари
генеалогический: генеалогического
генеалогия: генеалогии
генуя: генуя
германия: германия
главный: главным
год: гг год года году годы
гора: горы
гордон: гордон
город: город города городах городов
городок: городка
городской: городской
государственный: государственная
гражданство: гражданство
график: график
графика: графика
грикора: грикора
гримс: гримс
групповой: групповые групповых
гуснький: гуснек
далта: далта
данные: данным данных
дата: дата
два: две
дворцовый: дворцовая
де: де
действовать: действовать
декабрь: декабрь декабря
день: день
деревня: деревнях
десятый: десятое
детройт: детройт
деятель: деятели
деятельность: деятельности
джонрид: джонрид
диксон: диксон
диптих: диптихов
дле: дле
длина: длину
дм: дм
добавить: добавить
доджа: доджа
дом: дом домами доме
дон: дон
дополнительный: дополнительные
достигнуть: достичь
доступный: доступен
древо: древа
дрезден: дрезден дрездена
другой: других
дух: духа
европа: европы
ежедневный: ежедневной
ещё: ещё
живописец: живописец
живописный: живописные
живопись: живопись живописью
жизнь: жизни
жить: живет жил жила
журнал: журнал журнале журналом
заглавный: заглавная
заметка: заметки
заметный: заметных
заниматься: занималась заниматься
запись: запись
заполнить: заполнить
зарегистрировать: зарегистрированный
заявление: заявление
зелёный: зеленого
зимбабве: зимбабве
знак: знак
значительный: значительную
изабелла: изабелла изабеллы
избранный: избранные избранных
известность: известности
известный: известные известный
издательский: издательский издательскими
издательство: издательствами издательство издательством
измениться: изменился
изначально: изначально
изображение: изображениями
изобразительный: изобразительному
изящный: изящных
иллюстратор: иллюстратор
имя: имя имён
индийский: индийская
индия: индии
институт: институт института
инструмент: инструменты
интересный: интересные
иосиф: иосифа
ирина: ирина
искусство: искусств искусства искусство искусству
использование: использования
использовать: использующие
история: историю история
источник: источник
исусство: исусств
италия: италия
итальянский: итальянским
июль: июль
июнь: июня
йорк: йорк йорка йорке
йоркский: йоркская йоркский
йоханнесбург: йоханнесбург
калифорнийский: калифорнийский
калифорния: калифорнии
канада: канада канады
карабах: карабаха
каракорум: каракорум
карлос: карлос
картина: картина картины
каталог: каталог каталога каталогу
катарин: катарина
категория: категории
кауфман: кауфмана
качество: качестве
квартейра: квартейра
квартирный: квартирных
квинс: квинс
кейптаун: кейптаун
кеньон: кеньон
керамик: керамике
керамика: керамикой
китай: китай
классический: классической
клейтон: клейтон
кливленд: кливленд кливленда
книга: книга книги
книжный: книжными
код: код
кодекс: кодекс
количество: количестве
колледж: колледжа
коллекция: коллекции коллекция коллекциях
комбинат: комбината
коммуна: коммуны
композиция: композиции
конфиденциальность: конфиденциальности
копейка: копеек
копия: копии
корнеллский: корнеллского
короткий: короткий
корпоративный: корпоративных
корпорация: корпорация
который: которая которую который
кошка: кошки
красный: красная
кристалтека: кристалтек
кристиансанда: кристиансанд
круз: круз крузе
крупный: крупнейшей
кук: куки
культура: культуры
культурный: культурный
культурый: культурый
лагуш: лагуш
латинский: латинскую
леопард: леопард
лестница: лестница
лето: лето
лига: лиге
линчёпинг: линчёпинг
лисабон: лисабон
лицензия: лицензии
лобо: лобо
лола: лоле
лонг: лонг
лондон: лондон
лоренцо: лоренцо
лос: лос
лурдес: лурдес
м: м
май: мая
малый: меньшей
мара: мар
маракеш: маракеше
март: март марта
мартирос: мартирос
маршрут: маршруту
масло: масло
масловка: масловке
материал: материал
мать: мать
машина: машина
международный: международная международной
мера: мере
место: место
метрополитен: метрополитен
миннеаполис: миннеаполис
мир: мир мира мире миру
михаилович: михайловна
мичиган: мичиган
младший: младшего
многий: многих
мобильный: мобильная
моз: мозе
мойра: мойра
монастырь: монастырь
монаша: монаша
монголия: монголии
монография: монографию монография
москва: москва москве
московский: московских московского московское
мочь: могут
муж: мужу
музей: музеи музей музеях
муниципальный: муниципальная
мы: нами
мыс: мыса
навеять: навеянные
навигация: навигации навигация
надежда: надежда
название: название названия
наказание: наказание
напечатать: напечатана
написать: написал
наркотик: наркотики
национальный: национальная национальной
наш: наш
неаполь: неаполь
недоступный: недоступная недоступные
некоммерческий: некоммерческой
неконформист: неконформистов
некоторый: некоторые
немой: нем
неопр: неопр
неофициальный: неофициальных
новый: новые
нонконформист: нонконформистов
норв: норв
норвегия: норвегии норвегию норвегия
нортон: нортона
ночь: ночь
ноябрь: ноября
нью: нью
ньюз: ньюз
нэнси: нэнси
обзор: обзор
облегчить: облегчило
обложка: обложки
обмен: обмен
образование: образование
обращение: обращения
обсуждение: обсуждение
объединить: объединила
объездить: объездил
ог: ог
окончание: окончания
окончить: окончил
октябрь: октябрь октября
ольяна: ольян
описание: описание
оптический: оптический
опубликовать: опубликовал
организация: организации
оригинал: оригинала
осенний: осенний
осло: осло
остров: остров островов
ответственность: ответственности
отдельный: отдельные отдельных
отель: отель
отказ: отказ
открытый: открытый
отметить: отмечено
отправляться: отправлялся
отредактировать: отредактирована
оттава: оттава
официальный: официальный
ошибка: ошибке
пакистан: пакистана
памятник: памятник
пан: пан
париж: париж
пасха: пасхи
патио: патио
педагог: педагог
пейзажист: пейзажист
первый: первая первую
переехать: переехал переехала
перейти: перейти
период: период
периодически: периодически
персоналия: персоналии
персональный: персональные персональных
печать: печати печать
писатель: писатель
плакатист: плакатист
планета: планет
пластика: пластики
плющиха: плющихе
поведение: поведения
подарок: подарок
подробный: подробнее подробную
пожертвовать: пожертвовать
поздний: позднее
поиск: поиск поиску
показывать: показывал
политика: политика
полотно: полотна
получать: получал
получить: получил получить
пометка: пометки
помимо: помимо
поприще: поприще
порт: порт порту
португалия: португалии португалия
посвятить: посвятили
посетить: посетил
последний: последний
постоянный: постоянная
поступить: поступил
потомок: потомком
потомственный: потомственный
править: править
правка: правки
прай: прайа
предок: предками
представиться: представились
предшественник: предшественников
примат: примат
примечание: примечания
принадлежащий: принадлежащие
природа: природа
приставной: приставная
причём: причём
продать: продана проданы
проделать: проделал
продолжать: продолжает продолжая
продолжить: продолжил
проект: проект проектах
произведение: произведения
происхождение: происхождение
промышленный: промышленное
просмотр: просмотры
пространство: пространства
профессиональный: профессиональный профессиональных
проходить: проходила
прыжок: прыжок
птица: птиц
публикация: публикации публикаций публикациях
публичный: публичная
пугать: пугает
путешественник: путешественников
путешествие: путешествие
путешествовать: путешествовать
путь: пути путь
пять: пять
р: р
работа: работ работа работы
работать: работает работал работала
рабочий: рабочие
разместить: разместили
разный: разных
разработчик: разработчики
располагаться: располагаются
рассказ: рассказы
расширение: расширение
ратти: ратти
реализм: реализма
реар: реар
ребёнок: детей
реестр: реестр
река: реке
рекламный: рекламными
рестарасао: рестарасао
род: рода
родиться: род родившиеся родился
родный: родная
рождение: рождении рождения
роза: роза
розенберг: розенберга
россия: россии россия
рубен: рубен
руперт: руперт
русе: русе
русский: русский русского
рыба: рыба
рынок: рынок
ряд: ряд ряды
сайт: сайт
саксонский: саксонская
салон: салон
самый: самых
сан: сан
сандро: сандро
сант: санта
сантон: сантон
саркисян: саркисян
сарьян: сарьян
св: св
сведение: сведения
свежий: свежие
свет: света
свободный: свободное свободной
свойство: свойство
связанный: связанные
связаться: свяжитесь
северный: северную
семья: семья
сентябрь: сентября
сергеевич: сергеевич
серия: серии
сестра: сестра
сибирь: сибири
сидней: сидней
сиднейский: сиднейского
символ: символами
символист: символисты
система: системе
скачать: скачать
скрытый: скрытые
след: след
следующие: следующии
следующий: следующие следующих следующую
служба: службы
служебный: служебные
случай: случаях
случайный: случайная
смитсоновский: смитсоновского
смотреть: см
снег: снегу
собрать: собраны
событие: события
совершить: совершил
совет: совет
советский: советский советское советской
современник: современников
современный: современного
содержание: содержание
создавать: создает
создать: создал создать
сообщество: сообщество
сообщить: сообщить
сотбис: сотбис
сотрудничать: сотрудничал
сохранение: сохранением
соцреализм: соцреализма
соцреалист: соцреалисты
союз: союз союза
справка: справка
ссср: ссср
ссылаться: ссылается
ссылка: ссылка ссылки
ставангер: ставангер
старый: старая
статистика: статистика
стать: стал
статья: статье статьи статья
степанович: степанович
стивен: стивена
стокгольм: стокгольм
сторона: сторону
страна: стран страна
страница: страница странице страницу страницы
странник: странник
строганов: строганова
студент: студентов
субал: субал
сурен: сурен сурена сурену
сусанна: сусанна
сша: сша
сын: сын сыну
сюда: сюда
сюрреалист: сюрреалисты
сюрреалистический: сюрреалистические
тавира: тавира
так: т
также: также
такой: такие
талантливый: талантливых
талс: талса
творческий: творческая творческие творческих творческой
творчество: творчества творчество
театральный: театральный
тейт: тейт
текст: текст
текущий: текущие
телефон: телефон
темп: темпе
товарный: товарный
токио: токио
триптих: триптих триптихов
удаться: удалось
указание: указанием
указанный: указанных
указать: указан
университет: университет университета
упомянуть: упомянутая
условие: условий условия
условный: условное
участвовать: участвовал участвовать
участие: участие
училище: училище
учреждение: учреждений
учётный: учётную
ф: ф
факт: факты
фамилия: фамилией
фантаст: фантаст
фарый: фаро
февраль: февраль
фериа: фериа
филбрук: филбрук
фонд: фонд фондах
форма: форм форме
форум: форум
фотограф: фотограф фотографы
фотографический: фотографические
фотография: фотографии
фр: фр
франциско: франциско
франция: франция
фьёрдс: фьёрдс
х: х
хагар: хагар
характер: характер
характеристика: характеристики
хараре: хараре
хемпстед: хемпстед
ходожник: ходожников
холст: холст
хофстр: хофстра
художественно: художественно
художественный: художественный
художник: художник художника художнике художники художников художником
художница: художница
хунзе: хунзе
целый: целые
центр: центр центра
центральный: центральную
цитировать: цитировать
цифровой: цифровая
чайка: чайка
часть: часть
человек: людях человек
чикаго: чикаго
чикагский: чикагская чикагский
число: числе
читать: читать
член: членом
чудо: чудеса
швед: швед
швеция: швеции швеция
шкода: шкода
шмаков: шмакова
штамп: штампами
штат: штата
шёлковый: шелкового шелковый
эверард: эверард
эдуардо: эдуардо
экспедиция: экспедиции
экспорт: экспорт
элект: электа
элемент: элемент
энциклопедия: энциклопедии
эротика: эротика
эссе: эссе
эсторить: эсторил
этнографический: этнографические
это: это
этот: эта
эфемейра: эфемейра
юар: юар
юг: юге
южный: южной южному южную
ют: юта
яблоко: яблоко
являться: является являющийся
язык: язык языках языке
январь: января
япония: япония
ярмарка: ярмарка
