аба: аба
абаев: абаева
абай: абаев
август: августа
авторство: авторства
агентство: агентство
айдаркен: айдаркен айдаркене
академия: академии
алфавит: алфавиту
ао: ао
артпоиск: артпоиск
архивировать: архивировано
архитектура: архитектуры
баткенский: баткенская
биография: биографии биография
бойцов: бойцова
быть: е
василий: василию
век: века
верещагин: верещагину
вернуться: вернулась
версия: версии версия
викидать: викиданных
викимедиа: викимедиа
википедия: википедии википедия
виктор: виктор
вклад: вклад
войти: войти
волшебный: волшебные
впечатление: впечатления
выпускник: выпускники
выставка: выставке
г: г
германия: германии
год: год года годах годов году лет
город: город
грозненский: грозненский грозненской
грозный: грозный
дата: дата
действовать: действовать
депортация: депортации
деятельность: деятельности деятельностью
дополнительный: дополнительные
доступный: доступен
другой: других
ева: ев
ещё: ещё
её: её
жанр: жанр
живопись: живописи
жизнь: жизни
жить: жить
заглавный: заглавная
заниматься: занимается
занятие: занятий
запись: запись
зарегистрировать: зарегистрированный
заслужить: заслуженные заслуженный
заявление: заявление
знак: знак
иван: иван
избранный: избранные
известный: известному
издательско: издательско
изменение: изменения
изображение: изображений
изобразительный: изобразительное
изостудия: изостудии
илья: ильи
ильяс: ильясов
имя: имени имён
институт: институт института
инструмент: инструменты
инфо: инфо
информационный: информационное
искусство: искусство
использование: использования
использовать: использующие
история: история
источник: источник
июнь: июня
кадамжайский: кадамжайском
картина: картин картина
категория: категории
киргизский: киргизская киргизской
китай: китае
код: код
кодекс: кодекс
коллекция: коллекциях
комплекс: комплекс
конец: конце
конфиденциальность: конфиденциальности
корея: корее
короткий: короткий
который: которая
кук: куки
культура: культуры
кыргызстан: кыргызстан
ламтюгин: ламтюгин
ланка: ланке
латта: латта
ленинград: ленинграде
лечить: леча
литература: литература
лицензия: лицензии
м: м
март: марта
мастерская: мастерской
материал: материал
махачкалинский: махачкалинское
место: место
многие: многие
мобильный: мобильная
мотив: мотивам
мочь: могут
мы: нами
н: н
навигация: навигации навигация
награда: награды
наука: науки
начать: начал
некогда: некогда
некоммерческий: некоммерческой
неопр: неопр
нович: нович
новый: новые
нохчийна: нохчийн
ноябрь: ноября
ныне: ныне
область: область
обращение: обращения
обсуждение: обсуждение
общественный: общественной
ожидать: ожидают
окончание: окончания
окончить: окончил
октябрь: октября
описание: описание
организация: организации
оригинал: оригинала
остаться: остался
ответственность: ответственности
отдельный: отдельных
отказ: отказ
отобразить: отобразил
отредактировать: отредактирована
ошибка: ошибке
ошский: ошская
пейзаж: пейзаж пейзажей
перейти: перейти
переятенец: переятенец
персоналия: персоналии
персональный: персональные
петербург: петербурга петербурге
петербургский: петербургский петербургской
петрович: петрович
печать: печати печать
поведение: поведения
подробный: подробнее
пожертвовать: пожертвовать
поиск: поиск поиску
полиграфический: полиграфический
политика: политика
получить: получить
польша: польше
помимо: помимо
пос: пос
посвятить: посвящённых
последний: последний
постоянный: постоянная
править: править
правка: правки
представить: представлена
представиться: представились
преподаватель: преподавателем
преподавательский: преподавательской
примечание: примечания
принадлежать: принадлежала
проверить: проверена
проверка: проверки
проект: проектах
проживать: проживал
просмотр: просмотры
пространство: пространства
профессиональный: профессиональной
работа: работы
работать: работает
рабочий: рабочий
развитие: развития
разработчик: разработчики
район: район районе
рано: рано
репин: репина
республика: республики
рисовать: рисовать
родина: родиной родину
родиться: род родившиеся родился
рождение: рождения
российский: российский российской
россия: россии россия
русский: русский
санкт: санкт
сведение: сведения
свежий: свежие
свободный: свободной
свой: своей
связанный: связанные
связаться: свяжитесь
связь: связи
семья: семья
сентябрь: сентября
серия: серии
сеул: сеуле
система: системе
скачать: скачать
скрытый: скрытые
скульптура: скульптуры
служебный: служебные
случай: случаях
случайный: случайная
смотреть: см
событие: события
советский: советский
современник: современников
содержание: содержание
создать: созданы создать
сообщество: сообщество
сообщить: сообщить
сохранение: сохранением
союз: союза союзов
справка: справка
сср: сср
ссср: ссср
ссылка: ссылка ссылки
стабильный: стабильная
статистика: статистика
статья: статьи статья
страна: страна странах
страница: страница странице страницу страницы
султ: султа
султан: султан султана
сша: сша
сюда: сюда
так: т
текст: текст
текущий: текущая текущие
терять: теряет
тип: тип
товарный: товарный
указ: указ
указание: указанием
условие: условий условия
участие: участие
училище: училище
учиться: учился
учётный: учётную
фамилия: фамилией
февраль: февраля
федерация: федерации
фонд: фонд
форум: форум
фрунзенский: фрунзенский
х: х
хабаров: хабарова
хайдаркан: хайдаркан
храниться: хранятся
художественный: художественное художественной
художество: художеств
художник: художник художника художники художников художнику
цитировать: цитировать
частный: частных
человек: людях человек
чечен: чечен
чеченец: чеченец
чеченский: чеченского чеченское чеченской
чечня: чечни
читать: читать
член: член члены
шаблон: шаблонов
шамсутдинович: шамсутдинович
шамсутдить: шамсутди
школа: школе
шри: шри
экз: экз
экспорт: экспорт
элемент: элемент
энциклопедия: энциклопедии
этап: этапа
этот: эта
язык: языках
япония: японии
