абдулаев: абдулаев
авторство: авторства
азия: азии
аласха: аласха
аласхан: аласханов
аласханов: аласханову
алфавит: алфавиту
анни: анни
апрель: апреля
армия: армий
архивировать: архивировано
аслахан: аслаханов
асср: асср
багаев: багаев багаева
батор: батор
биография: биографии биография
богий: богиев
борец: борец борцы
борьба: борьба борьбе борьбой
бронзовый: бронзовым
бухарест: бухарест
вадим: вадим
варшавский: варшавского
век: века
версия: версия
вес: вес
взрослый: взрослых
викидать: викиданных
викимедиа: викимедиа
википедия: википедии википедия
вклад: вклад
внешний: внешние
войти: войти
волшебный: волшебные
вольный: вольная вольного вольной
вооружённый: вооруженных
воспитанник: воспитанники
выполнить: выполнил
выставить: выставлены
г: г
галерея: галерее галерея
год: года году лет
государственный: государственная государственной государственные
дата: дата
действовать: действовать
договор: договора
дополнительный: дополнительные
достижение: достижения
доступный: доступен
другой: другие других
дружественный: дружественных
дэг: дэги
европа: европы
ещё: ещё
живопись: живопись
жирардо: жирардо
заглавный: заглавная
зайналбекович: зайналбекович
зайналоб: зайналбе
зайнди: зайнди
заниматься: заниматься
занятие: занятий
запас: запаса
запись: запись
зарегистрировать: зарегистрированный
заслужить: заслуженные заслуженный
заявление: заявление
звание: звание звания
знак: знак
знаменитый: знаменитая
золото: золото
игра: игр
избранный: избранные
известный: известные известных
изображение: изображений изображения
имя: имени имён
ингушетия: ингушетии
ингушский: ингушская ингушской
инструмент: инструменты
интересный: интересный
информация: информация
использование: использования
использовать: использующие
исток: истоки
история: история
источник: источник
кадыров: кадырова
казахстан: казахстана
карьера: карьера
категория: категории
катиновас: катиновасов
кг: кг
киноактриса: киноактриса
класс: класса
клуб: клуб
кович: кович
код: код
кодекс: кодекс
командный: командного командный
конфиденциальность: конфиденциальности
короткий: короткий
который: которая
кратный: кратный
кубок: кубка кубков кубок
кук: куки
кулон: кулона
культура: культура
летний: летних
литература: литература
лицензия: лицензии
личный: личная
м: м
май: мая
майор: майора
март: марта
мастер: мастер мастера
материал: материал
медаль: медали
международный: международного
место: место
минск: минске
мир: мира
многократный: многократный
мобильный: мобильная
мовлади: мовлади
москва: москве москвы
московский: московский
мочь: могут
мужской: мужской
мы: нами
навигация: навигации навигация
награда: награды
находиться: находилась
начать: начал
некоммерческий: некоммерческой
неопр: неопр
новый: нов новые
норматив: норматив
нохчийна: нохчийн
обладатель: обладатель
обращение: обращения
обсуждение: обсуждение
округ: округ
олимпийский: олимпийских
описание: описание
организация: организации
оригинал: оригинала
ответственность: ответственности
отдельный: отдельных
отказ: отказ
отредактировать: отредактирована
ошибка: ошибке
память: памяти
париж: париж
пво: пво
первый: первый
перейти: перейти перешёл
перо: перо
персоналия: персоналии
персональный: персональные
печать: печати печать
победитель: победитель
поведение: поведения
повышение: повышением
подготовить: подготовил
подробный: подробнее
пожертвовать: пожертвовать
поздравить: поздравила
поиск: поиск поиску
пол: пол
политика: политика
полковник: полковник
получить: получить
польша: польша
последний: последний
постоянный: постоянная
править: править
правка: правки
представиться: представились
преображенский: преображенский преображенского
призёр: призёр призёром
примечание: примечания
присвоение: присвоения
присвоить: присвоено
присутствовать: присутствовала
проект: проектах
просмотр: просмотры
пространство: пространства
пустой: пуст
работа: работ работу
разработчик: разработчики
расул: расул
родиться: род родившиеся родился
рождение: рождения
роже: роже
россия: россии россия
рсфср: рсфср
руководство: руководством
русский: русский
ряд: ряд
сагида: сагид
самодеятельный: самодеятельный
сведение: сведения
свежий: свежие
свободный: свободной
связанный: связанные
связаться: свяжитесь
семья: семья
сергей: сергей сергея
серебро: серебро
серебряный: серебряный
сила: сил
система: системе
скачать: скачать
скрытый: скрытые
служебный: служебные
случай: случаях
случайный: случайная
смотреть: см
событие: события
советский: советский
современник: современников
современность: современность
содержание: содержание
создать: создать
сообщество: сообщество
сообщить: сообщить
сохранение: сохранением
спартакиада: спартакиада спартакиады
специализация: специализация
спорт: спорт спорта
спортивный: спортивная спортивные
спортсмен: спортсменов спортсмены
справка: справка
среди: среди
ссср: ссср
ссылка: ссылка ссылки
статистика: статистика
стать: ставший стал
статья: статьи статья
стиль: стиля
страна: стран страна страны
страница: страница странице страницу страницы
съёмка: съёмок
сын: сын
сюда: сюда
тбилисский: тбилисского
текст: текст
текущий: текущие
тимур: тимур
тип: тип
товарный: товарный
тренер: тренер тренера тренеры
тренерский: тренерскую
тренироваться: тренироваться
турнир: турнира
указание: указанием
улан: улан
условие: условий условия
участие: участие
учётный: учётную
факт: факт
фамилия: фамилией
февраль: февраля
фигурист: фигурист
физический: физическая
фильм: фильма
фонд: фонд
форум: форум
французский: французская
х: х
хизрий: хизриев
художник: художник художники
целый: целый
церемония: церемонии
цитировать: цитировать
цска: цска
человек: людях человек
чемпион: чемпион
чемпионат: чемпионат чемпионата
чеченец: чеченец
чеченский: чеченский чеченского
чечня: чечни
чечь: чечено
читать: читать
шаблон: шаблон
экспорт: экспорт
элемент: элемент
энциклопедия: энциклопедии энциклопедия
этот: эта
юниор: юниоров
юноша: юношей
язык: языках
