авторитетный: авторитетные
авторский: авторской
авторство: авторства
агаев: агаев
академия: академии
актуальный: актуальные
алфавит: алфавиту
алчный: алчную
альбом: альбом альбомов
апрель: апреля
арбат: арбате
армия: армии
артист: артиста
архивировать: архивировано
беда: бед
библиотека: библиотека
биография: биография
битва: битва
бить: били
блокада: блокада
больший: большим
большой: большого
борьба: борьбе
брагин: брагин
брюссель: брюсселе
бурный: бурной
быть: будучи е
вашингтон: вашингтон
ведущий: ведущих
век: века
великий: великого великой
версия: версия
верховный: верховного
веха: вехи
вечерний: вечерняя
вид: виде
викидать: викиданных
викимедиа: викимедиа
википедия: википедии википедия
витрина: витринах
вклад: вклад
власть: власть
вне: вне
внимание: внимания
война: войны
войти: войти
время: время
входить: входили
вывешивать: вывешивали
выполнить: выполненные
выпускать: выпускал
выпустить: выпустил
высмеивать: высмеивали
выставить: выставлено
выставка: выставках выставке
выставляться: выставлялись
г: г
газета: газетах газете газету газеты
главный: главным
го: го
говорить: говорит
год: год года годов году годы лет
голос: голосом
гора: горе
город: городов
готовый: готова
группа: группа группу группы
дата: дата
дать: данная
дворец: дворца
де: де
действовать: действовать
день: дня
депутат: депутатов
депутатский: депутатском
держава: державу
деятель: деятели
деятельность: деятельности
джангир: джангир джангира
директор: директором
добавить: добавив добавить
долгорукий: долгорукого
должный: должна
дообеденный: дообеденному
дополнительный: дополнительные
доступный: доступен
другой: другие другими других
еженедельно: еженедельно
ерёмин: еремин
ещё: ещё
её: её
жанейро: жанейро
жанр: жанр
жизнь: жизни
журнал: журнале журналом
журналист: журналистов
завод: заводе
заглавный: заглавная
заказ: заказу
занятие: занятий
запись: запись
зарегистрировать: зарегистрированный
заставлять: заставлял
заявление: заявление
зил: зил
знак: знак
иванов: иванов
избранный: избранные
известие: известий
известный: известнейшими известные
издание: изданиями
издать: издал
изображение: изображений
изобразительный: изобразительного
изолировать: изолированные
изоплакат: изоплакат
иллюстрировать: иллюстрированной
имущий: имущих
имя: имён
иначе: иначе
инна: инн
инструмент: инструменты
интерес: интересов
информация: информации информация
искусство: искусства
использование: использования
история: историей истории история
источник: источник источники источников
июнь: июнь
какой: каким
карандаш: карандаш
карикатура: карикатура карикатуры
карикатурист: карикатурист карикатуристов карикатуристы
категория: категории
книга: книги
код: код
кодекс: кодекс
комитет: комитета
комсомольский: комсомольский
конгресс: конгресса
конкурс: конкурсе
контакт: контакты
конфиденциальность: конфиденциальности
коридор: коридоре
корнев: корнев
короткий: короткий
коррупция: коррупцию
костюм: костюмах
кремлёвский: кремлёвского
критиковать: критиковали
крокодил: крокодил крокодила
кук: куки
лауреат: лауреат
ленинград: ленинграда
летие: летию
литературный: литературный
лицензия: лицензии
лондон: лондона
лужков: лужкова
май: мае мая
мальта: мальты
манера: манере
массовый: массовой
материал: материал
международный: международного международных
мера: мере
место: место
меткий: меткое
мир: мир
многократный: многократный
мобильный: мобильная
москва: москва москве москвы
московский: московского
мохов: мохов
мочь: могут можете
мудрый: мудрый
музей: музее музея музеях
мы: нами
мэр: мэра
навигация: навигации навигация
нагрубить: нагрубить
название: названием
нарисовать: нарисовал
народ: народа
народный: народных
находиться: находятся
начало: начале
наш: нашей
недостаток: недостатков
некоммерческий: некоммерческой
нелёгкий: нелегкой
неопр: неопр
несколько: нескольких
никулин: никулина
новый: новом новые
ноябрь: ноября
обидеть: обидеть
обидно: обидно
обозрение: обозрение
обращение: обращения
обсуждение: обсуждение
общезаводский: общезаводские
общественность: общественности
общество: общества
огрн: огрн
один: одно
окно: окна
он: нему
ооо: ооо
описание: описание
опубликовать: опубликовал
организация: организации
организовать: организовал организованной
оригинал: оригиналов
оригинальный: оригинальной
основатель: основателем
основной: основные
оставлять: оставляя
останавливать: останавливало
остро: остро
ответственность: ответственности
отвратительный: отвратительно
отдельный: отдельных
отечественный: отечественной отечественных
отзыв: отзывы
отказ: отказ
открыть: открыл
отображение: отображение
отразить: отразили
отредактировать: отредактировать
отыскать: отыскать
оченьжитейский: оченьжитейским
ошибка: ошибке
первый: первому
перейти: перейти перешел
перерыв: перерыву
перестройка: перестройки перестройку
период: период
персонаж: персонажами
персоналия: персоналии
персональный: персональные
печаль: печали
печататься: печатался
печатный: печатными
печать: печати печать
пионер: пионер
плакат: плакат плаката плакатов плакаты
площадь: площади
победа: победы
победить: победив
поведение: поведения
поддерживать: поддерживая
подробный: подробнее
пожалуйста: пожалуйста
пожертвовать: пожертвовать
поиск: поиск поиску
поклонный: поклонной
политика: политика
политический: политические политическое политической
полный: полной
половина: половиной
получить: получить
попадать: попадали
порок: пороков
посвятить: посвященных
последний: последнего
послеперестроечный: послеперестроечный
правда: правда
править: править
правка: правки
право: правами
председатель: председатель
представиться: представились
премия: премий
пригласить: приглашен
признать: признан
примечание: примечания
принять: принятыми
приобрести: приобрела
проверять: проверяема
проверяться: проверялась
проект: проектах
прожектор: прожектор
проникаться: проникаюсь
проработать: проработал
просмотр: просмотры
пространство: пространства
просьба: просьбе
прощать: прощай
пушкинский: пушкинской
работа: работ работе работу работы
работать: работал работали
развернуться: развернувшуюся
раздражать: раздражало
разный: разное разных
разработчик: разработчики
рахимович: рахимович
регламент: регламента
редактор: редактор редактором
редакция: редакцию
рейтинг: рейтинг
реквизит: реквизиты
рекомендация: рекомендации рекомендациями
реутов: реутова
ржев: ржева ржевом
рио: рио
рисунок: рисунках рисунков
родиться: род родившиеся родился
рождение: рождения
российский: российский российских
россия: россии россию россия
руководство: руководства
русский: русский
русый: рус
рыбак: рыбаком
рыбалка: рыбалка рыбалке
сам: самого
сатира: сатира сатирой
сатирический: сатирические сатирического
сведение: сведения
свежий: свежие
свободный: свободной
свой: своей своих
связанный: связанные
связать: связать
связаться: свяжитесь
сдерживаться: сдерживаться
семь: семь
сентябрь: сентября
серия: серию серия
система: системе
скачать: скачать
скрытый: скрытые
служба: службы
служебный: служебные
случай: случаях
случайный: случайная
слушать: слушаю
смерть: смерти
смотреть: см
сноска: сносок
событие: событие события
совет: совета
советский: советский
современный: современной
содержание: содержание
создать: создал создать
сообщество: сообщество
сообщить: сообщить
соответствие: соответствии
соответствующий: соответствующими
состав: состав
сотня: сотни
сотрудничать: сотрудничал
сохранение: сохранением
союз: союзом
справка: справка
среди: среди
средство: средствам
срывать: срывали
ссср: ссср
ссылаться: ссылаются
ссылка: ссылки ссылок
сталинградский: сталинградская
статистика: статистика
стать: стал
статья: статье статьи статью статья
стекло: стёкла
столица: столицы
страна: страна стране страны
страница: страница странице страницы
страстный: страстным
сша: сша
съезд: съезда съездах съезде
сюда: сюда
также: также
тара: тары
творческий: творческой творческую
текст: текст
текущий: текущие
тема: темы
тип: тип
товарный: товарный
уважение: уважением
увидеть: увиденное
угрожать: угрожали
удалить: удалена
уйти: ушел
указание: указанием
уличный: уличного уличных
умерший: умершие
условие: условий условия
установить: установите
участвовать: участвовал
участие: участие
участник: участниками
учётный: учётную
ущемление: ущемление
фамилия: фамилией
фестиваль: фестиваля
фломастер: фломастером
фонд: фонд
форум: форум
х: х
хамелеонство: хамелеонство
хватать: хватает
хороший: лучшим
хрипловатый: хрипловатым
художество: художеств
художник: художник художника художникам художники художников художником
центр: центре
центральный: центрального
человек: людях человек
человеческий: человеческое
черепанов: черепанов
четыре: четырёх
читать: читать
шаблон: шаблонами
экземпляр: экземпляров
экономический: экономические
экспозиция: экспозиций
экспорт: экспорт
элемент: элемент
энциклопедия: энциклопедией энциклопедии
эпоха: эпох
это: это
юмористический: юмористических
юный: юных
юрий: юрия
являться: являлся являются
язык: языках
