автор: автор
авторство: авторства
агаджанян: агаджаняна
айриванк: айриванк
академия: академии
алфавит: алфавиту
апрель: апреля
араратский: араратская
арма: арм
армения: армении
армянский: армянская армянской армянском
архитектура: архитектуры
аршакович: аршаковна
асламазян: асламазян
баш: баш
беларускать: беларуская
библиографический: библиографических
биография: биография
български: български
быть: е
вд: вд
век: века
великий: великой
версия: версии версия
викидать: викиданных
викимедиа: викимедиа
википедия: википедии википедия
викисклад: викисклад викискладе
вклад: вклад
внешний: внешние
война: войны
войти: войти
восточный: восточная восточной
время: времени
выпечка: выпечка
выпускник: выпускники
выставка: выставки
галерея: галерее галерея
гдр: гдр
генеалогия: генеалогия
герой: героя
год: года годах году годы лет
город: городе
государственный: государственной
гравюра: гравюре
график: график
графика: графики
гюмри: гюмри
дата: дата
действовать: действовать
детство: детстве
деятельность: деятельности
долина: долина
дом: дом
дополнительный: дополнительные
доступный: доступен
дрезденский: дрезденская дрезденской
другой: других
езерский: езерская
еран: еран
ерануи: ерануи
ереванский: ереванском
ещё: ещё
жанр: жанр
жанрист: жанристы
жанровый: жанровая жанровых
живописец: живописец
живопись: живописи живопись
заглавный: заглавная
заниматься: занималась
запись: запись
запрос: запросы
зарегистрировать: зарегистрированный
заслужить: заслуженные заслуженный
затем: затем
заявление: заявление
звание: звания
знак: знак
значительно: значительно
избранный: избранные
илья: ильи
империя: империя
имя: имени имя имён
институт: институт институте
инструмент: инструменты
искусство: искусстве
использование: использования
исследовательский: исследовательском
история: история
источник: источник источниками
кавказский: кавказский
карсскай: карсская
карсский: карсский карсской
картина: картина картины
каталог: каталогах
категория: категории категория
керамика: керамикой
керамистый: керамисты
керамический: керамическая керамические
кладбище: кладбище
код: код
кодекс: кодекс
коллекция: коллекции
конфиденциальность: конфиденциальности
короткий: короткий
край: край
кук: куки
лаваш: лаваша
ленинград: ленинграда ленинграде
ленинградский: ленинградском
литература: литература
лицензия: лицензии
любить: любила
м: м
май: мая
мариам: мариам
марка: марке
материал: материал
медиафайл: медиафайлы
место: место
мобилизовать: мобилизовала
мобильный: мобильная
москва: москва москве москвы
мочь: могут
музей: музее музей музея музеях
мы: нами
н: н
навигация: навигации навигация
награда: награды
народный: народный
натюрморт: натюрмортов
научно: научно
находиться: находятся
национальный: национальная национальной
некоммерческий: некоммерческой
некрополистик: некрополистика
новый: новые
нська: нська
область: области область
обсуждение: обсуждение
обучаться: обучалась
округ: округ
описание: описание
опытный: опытными
орбель: орбели
организация: организации
осьмеркин: осьмеркина
ответственность: ответственности
отдельный: отдельных
отечественный: отечественной
отказ: отказ
откликаться: откликающихся
отличаться: отличаться
отредактировать: отредактирована
оформление: оформлении
ошибка: ошибке
память: память
пейзаж: пейзаж пейзажей
пейзажист: пейзажисты
переехать: переехала
перейти: перейти
персоналия: персоналии
персональный: персональные
петербургский: петербургской
печать: печати печать
поведение: поведения
подробный: подробнее
пожертвовать: пожертвовать
поздний: позже
поиск: поиск поиску
пока: пока
политика: политика
полный: полное
полотно: полотен
получить: получить
поначалу: поначалу
портрет: портрет портретов
портретист: портретисты
последний: последний
постоянный: постоянная
похоронить: похоронена похороненные
почтовый: почтовой
править: править
правка: правки правок
представиться: представились
примечание: примечания
принадлежать: принадлежавшей
пробовать: пробовала
проверить: проверенной
проверка: проверки
проверяться: проверялась
продолжить: продолжила
проект: проектах
произведение: произведений произведения
просмотр: просмотры
пространство: пространства
работа: работа работы
работать: работала
разработчик: разработчики
расположить: расположен
реализм: реализм
ред: ред
репин: репина
ресурс: ресурсы
рисунок: рисунка
родиться: род родившиеся родилась
рождение: рождения
российский: российская российской
россия: россии россия
рубеж: рубежом
руководство: руководством
русский: русский
ряд: ряда
санкт: санкт
сведение: сведения
свежий: свежие
свободный: свободной
свой: своем свои
связанный: связанные
связаться: свяжитесь
село: селе
семья: семьёй
сестра: сестра сестёр
сила: силы
система: системе
скачать: скачать
скрытый: скрытая
скульптура: скульптуры
служебный: служебные
случай: случаях
случайный: случайная
смерть: смерти
смотреть: см
событие: события
советский: советская советский советской
содержание: содержание
создание: создание
создать: создать
сообщество: сообщество
сообщить: сообщить
сохранение: сохранением
союз: союза
справка: справка
сср: сср
ссср: ссср
ссылка: ссылка ссылки
статистика: статистика
статья: статьи статья
стиль: стиль
страна: страна
страница: страница странице страницу страницы
сформироваться: сформировалась
сюда: сюда
также: также
театральный: театральном
текст: текст
текущий: текущая текущие
техникум: техникуме
типично: типично
товарный: товарный
торговля: торговля
требовать: требуют
третьяковский: третьяковская третьяковского
трудовой: трудового
указание: указанием
укра: укра
умереть: умерла
умерший: умершие
условие: условий условия
участие: участие
участник: участниками
учитель: учителем
учёба: учёба учёбу
учётный: учётную
фамилия: фамилией
февраль: февраля
фонд: фонд
форум: форум
фрукт: фрукты
художественный: художественной художественном
художество: художеств
художник: художник художники художников
художница: художница художницей художницы
цитировать: цитировать
частность: частности
человек: людях
читать: читать
член: член
ширак: ширак
экспорт: экспорт
элемент: элемент
элита: элите
энциклопедия: энциклопедии
этот: эта
являться: является
язык: языках
