авторство: авторства
алфавит: алфавиту
англ: англ
андреев: андреев
андрей: андрей
архитектура: архитектуре
библиографический: библиографических
биография: биография
больший: большим
бульб: бульба
бывший: бывшего
век: века
великобритания: великобритании
вербицкий: вербицкой
версия: версии версия
видимый: видимому
викидать: викиданных
викимедиа: викимедиа
википедия: википедии википедия
вильгельм: вильгельм вильгельма
вина: вине
вино: вина вино
вклад: вклад
внешний: внешние
войти: войти
волга: волга
волна: волны
время: времени время
вызвать: вызвал
выйти: вышла
георг: георг георга
германия: германии
гл: гл
главный: главной
год: года годах году лет
гражданство: гражданство
данные: данным
дата: дата
датский: датская
действовать: действовать
декоратор: декоратор декоратором декораторы
деятель: деятели
добавить: добавив
дон: дон
дополнительный: дополнительные
доступный: доступен
другой: другим других
дух: дух
душа: души
единственный: единственный
естественный: естественных
ещё: ещё
её: её
женщина: женщины
заглавный: заглавная
занятие: занятий
записка: записки
запись: запись
запретить: запрещена
зарегистрировать: зарегистрированный
заявление: заявление
знак: знак
значительно: значительно
избранный: избранные
изображение: изображений
изобразительный: изобразительного
империя: империи империя
имя: имён
инструмент: инструменты
искусство: искусства
использование: использования
история: история
источник: источник
июль: июля
карьера: карьера
каталог: каталогах
категорически: категорически
категория: категории
кинематографист: кинематографист
кино: кино
кинопоиск: кинопоиск
кинорежиссёр: кинорежиссёр кинорежиссёры
кихот: кихот кихоте
код: код
кодекс: кодекс
конфиденциальность: конфиденциальности
короткий: короткий
который: которых
крепость: крепость
критика: критики
кук: куки
ленинград: ленинград
лицензия: лицензии
лоудун: лоудуне
любовь: любви любовь
март: марта
маска: маска
материал: материал
мелодрама: мелодрам
место: место
мобильный: мобильная
москва: москве
мочь: могут можете
мы: нами
навигация: навигации навигация
национальный: национальная
недостаток: недостатков
неизвестный: неизвестными
некоммерческий: некоммерческой
немецкий: немецкого
немой: нем
необходимость: необходимости
ниже: ниже
новый: новые
обсуждение: обсуждение
один: одна
однако: однако
описание: описание
опытный: опытными
организация: организации
ответственность: ответственности
отдельный: отдельных
отказ: отказ
отличаться: отличаться
отредактировать: отредактирована
отрицательный: отрицательные
отчество: отчества отчество
ошибка: ошибке
пабст: пабст пабста
пандора: пандоры
параметр: параметрами
париж: парижа
первый: первой
переименовать: переименовав
перейти: перейти
персоналия: персоналии
персональный: персональные
петербург: петербурге
печать: печати печать
пламя: пламени
поведение: поведения
подробный: подробнее
пожертвовать: пожертвовать
поиск: поиск поиску
пока: пока
политика: политика
полностью: полностью
получить: получить
пользоваться: пользовался
помочь: помочь
последний: последний
поставить: поставил
постоянный: постоянная
править: править
правка: правки правок
представиться: представились
примечание: примечания
причина: причин
проверить: проверенной
проверка: проверки
проверяться: проверялась
проект: проектах проекту
произведение: произведениям
просмотр: просмотры
пространство: пространства
профессия: профессия
работать: работал
разработчик: разработчики
раскольник: раскольников
режиссёр: режиссёр режиссёра
ресурс: ресурсы
роберт: роберта
родиться: род родившиеся
рождение: рождения
роль: роли
роман: роману
российский: российская российский российской
россия: россии
русский: русские русский
сайт: сайты
салонный: салонных
санкт: санкт
сведение: сведения
свежий: свежие
свободный: свободной
свой: своё
связанный: связанные
связаться: свяжитесь
святыня: святыней
система: системе
скачать: скачать
скрытый: скрытые
словарь: словари
служебный: служебные
случай: случаях
случайный: случайная
смерть: смерти
смотреть: см
снять: снял
событие: события
содержание: содержание
создать: создать
сообщество: сообщество
сообщить: сообщить
сохранение: сохранением
сохраниться: сохранившийся сохранился
справка: справка
среднее: среднего
ссср: ссср
ссылка: ссылка ссылки
статистика: статистика
статья: статье статьи статья
страница: страница странице страницу страницы
суждение: суждения
сша: сша
сыграть: сыграл
сюда: сюда
также: также
тарас: тарас
театр: театре
текст: текст
текущий: текущая текущие
тематический: тематические
тип: тип
тишина: тишины
тоболец: тобольцев
товарный: товарный
требовать: требуют
указание: указанием указания
указать: указано
умереть: умер
умерший: умершие
уровень: уровня
условие: условий условия
успех: успехом
участие: участие
участник: участниками
учиться: учился
учётный: учётную
фамилия: фамилией
февраль: февраля
фильм: фильм фильма фильме фильмы
фильмография: фильмография
фонд: фонд
форум: форум
франция: франции франция
фёдор: фёдор
художественный: художественном
художник: художник художники художником
цензура: цензурой
цитировать: цитировать
частично: частично
чей: чья
человек: людях человек человеке
читать: читать
шаблон: шаблона шаблонами
шавль: шавли
шаляпин: шаляпин
шяуляй: шяуляе
экспорт: экспорт
экспрессионист: экспрессиониста
элемент: элемент
эмигрант: эмигранты
эмигрировать: эмигрировал
энциклопедия: энциклопедии
этот: эта
юг: югу
язык: языках
январь: января
ящик: ящик
