автор: автор
авторство: авторства
аксаков: аксакову
активность: активности
аленький: аленький
алфавит: алфавиту
анкара: анкаре
анна: анна
антонов: антонов
апрель: апреля
арин: арина
архивировать: архивировано
архивный: архивная
байкальский: байкальские
балда: балде
безумный: безумного безумный
биография: биографии биография
блог: блог
борис: борис борисом
брашинский: брашинская
брэдбрать: брэдбери
век: века
версия: версии версия
вести: вести
викидать: викиданных
викимедиа: викимедиа
википедия: википедии википедия
виктор: виктор
вклад: вклад
войти: войти
вологодский: вологодском
впервые: впервые
г: г
газета: газета
гитис: гитиса гитисе
гладкий: гладких
гоголь: гоголя
год: года году годы
гражданство: гражданство
группа: группа
дата: дата
действовать: действовать
день: день дня
детский: детском
деятель: деятели
длина: длин
добавить: добавить
дополнительный: дополнительные
дорога: дороге
доступный: доступен
другой: других
ереван: ереване
ещё: ещё
железо: железо
женитьба: женитьба
жизнь: жизнь жизнью
журнал: журнал
заглавный: заглавная
запись: запись
заполнить: заполнить
зарегистрировать: зарегистрированный
заявление: заявление
знак: знак
значительно: значительно
золотой: золотая
иван: иван
иванов: иванова
ивановский: ивановская
избранный: избранные
изображение: изображениями
изобразительный: изобразительного
имя: имён
инструмент: инструменты
ирина: ирина
искусство: искусства
использование: использования
история: истории история
источник: источник
июнь: июня
кабанов: кабанова
камерный: камерном
карелия: карелия
кармена: кармен
категория: категории
каунасский: каунасском
кафедра: кафедра кафедре
киплинг: киплингу
ковбойский: ковбойская
код: код
кодекс: кодекс
компания: компании
комсомолец: комсомолец
константинов: константинов константиновым
конфиденциальность: конфиденциальности
копия: копия
короткий: короткий
который: которая
кошка: кошка
кренскай: кренская
крестьянский: крестьянский
кружево: кружево
ксения: ксения
куб: куб
кук: куки
кукла: куклы кукол
кукольник: кукольник
кукольный: кукольная кукольную кукольный
культпроект: культпроект
курс: курс курса
л: л
лапперант: лапперанта
лауреат: лауреат лауреаты
лгитмик: лгитмик лгитмика
ленинградка: ленинградка
литература: литература
лицензия: лицензии
любовь: любви
м: м
маленький: маленькие
марина: марина
марионетка: марионеткам марионетками марионеток
март: марта
маска: маска
мастер: мастер
материал: материал
место: место
минь: мини
мир: мира
многий: многих
мобильный: мобильная
московский: московский московском
мохов: моховой
мочь: могут
мы: нами
н: н
набрать: наберут
навигация: навигации навигация
награда: награды
национальный: национальной
некоммерческий: некоммерческой
неоднократный: неоднократный
неопр: неопр
нить: нитях
новый: новые
ноябрь: ноября
ныне: ныне
обезглавить: обезглавлены
образцов: образцова
обращение: обращения
обсуждение: обсуждение
объединение: объединения
обязать: обязан
окончить: окончил
олеся: олеся
опера: опера оперу
описание: описание
опытный: опытными
организация: организации
остров: остров
ответственность: ответственности
отдельный: отдельных
отказ: отказ
открытый: открытое
отличаться: отличаться
отредактировать: отредактирована
оформить: оформил
ошибка: ошибке
педагог: педагог педагоги
перейти: перейти
персоналия: персоналии
персональный: персональные
петербург: петербург петербурге
петербургский: петербургский
петрович: петрович
печать: печати печать
письмовник: письмовник
поведение: поведения
подробный: подробнее
пожертвовать: пожертвовать
поиск: поиск поиску
пока: пока
показать: покажет
политика: политика
получить: получить
поп: попе
пополам: пополам
пори: пори
последний: последний
поставить: поставил
постановка: постановка
постановочный: постановочная
постановщик: постановщик постановщиков
постоянный: постоянная
править: править
правка: правки правок
представиться: представились
премия: премии
престижный: престижных
призёр: призёр
примечание: примечания
проверить: проверенной
проверка: проверки
проверяться: проверялась
программа: программу
проект: проектах
просмотр: просмотры
пространство: пространства пространство
профессия: профессия
пушкин: пушкину
р: р
работать: работал
работник: работнике
разработчик: разработчики
райкин: райкина
ргись: ргиси
режиссёр: режиссер режиссёров
республика: республики
родиться: род родившиеся
рождение: рождения
российский: российская российский
россия: россии россия
рсфср: рсфср
рубеж: рубежом
русский: русский
русый: рус
рязанский: рязанском
санкт: санкт
сахалинский: сахалинского
сведение: сведения
свежий: свежие
свободный: свободной
свой: своим
свойство: свойство
связанный: связанные
связаться: свяжитесь
сентябрь: сентября
система: системе
сказка: сказка
скачать: скачать
скрытый: скрытые
служебный: служебные
случай: случаях
случайный: случайная
смотреть: см
событие: события
совместно: совместно
совместный: совместная
современник: современников
содержание: содержание
создать: создать
солнце: солнцу
сольный: сольную
сообщество: сообщество
сообщить: сообщить
сохранение: сохранением
спектакль: спектакле спектакли спектакль
специальность: специальности
справка: справка
ссср: ссср
ссылка: ссылка ссылки
стажироваться: стажировался
статистика: статистика
статья: статьи статья
сторона: сторону
страница: страница странице страницу страницы
студия: студии
сценограф: сценограф сценографы
сценография: сценографии
сын: сын
сюда: сюда
тамбов: тамбов тамбове
тамбовский: тамбовском
творческий: творческого
театр: театр театра театре
театральный: театральной театральный театральных
текст: текст
текущий: текущая текущие
теремок: теремок
товарный: товарный
тот: ту
требовать: требуют
турандот: турандот
указание: указанием
укули: укули
уникальный: уникальную
условие: условий условия
устинов: устинова
участие: участие
участник: участник участниками
учебный: учебном учебный
учётный: учётную
фамилия: фамилией
февраль: февраля
ферхат: ферхат
фестиваль: фестивалей
фигаро: фигаро
финляндия: финляндия
финско: финско
фонд: фонд
формат: формат
форум: форум
франция: франции
художник: художник художники художников
цветочек: цветочек
центральный: центрального центральном
цирк: цирк
цирковой: цирковыми
цитировать: цитировать
человек: людях
челябинский: челябинском
читать: читать
шепелёва: шепелёва
ширин: ширин
шишкин: шишкину
экологический: экологическая
экспедиция: экспедиция
экспорт: экспорт
элемент: элемент
энциклопедия: энциклопедии
эскобилие: эскобилья
этот: эта
язык: языках
