абориген: абориген
авангард: авангарда
август: август
автор: авторы
авторство: авторства
администрация: администрации
академия: академии
активный: активной
александр: александр александра
александро: александро
алфавит: алфавиту
анатолиевич: анатольевич анатольевича
англ: англ
андрей: андрея
антонышев: антонышев антонышева
антоныщев: антоныщев
ареццо: ареццо
аркон: аркона
арт: арт
артистический: артистическое
архивировать: архивированная архивировано
архивный: архивная
архитектор: архитекторов
арыкон: арыкона
б: б
бельгия: бельгия
библиография: библиография
библиотека: библиотека библиотеке
биография: биографии биография
благодат: благодатов
близкий: близка
блок: блока
боголюбов: боголюбова
больший: большей
большой: большой
боровский: боровский
боря: борей
бродячий: бродячая
будущий: будущему
быть: е
валерий: валерий
век: вв века веков
версия: версия
весенний: весенняя
весь: весь
видение: видения
видеофайл: видеофайлы
видеть: видим
видимый: видимого
визитный: визитной
викидать: викиданных
викимедиа: викимедиа
викиновость: викиновости
википедия: википедии википедия
викисклад: викисклад викискладе
викицитатник: викицитатник
вклад: вклад
власть: власти
влияние: влияние
вместе: вместе
внешний: внешние
вов: вов
возможность: возможность
войти: войти
волшебный: волшебные
впечатление: впечатления
время: время
вступить: вступил
всё: всё
входить: входили
выбор: выбор
выборгский: выборгский
выделяться: выделяются
выпускник: выпускники
выставить: выставлены
выставка: выставка выставке выставки выставок
выставочный: выставочного выставочном выставочный
г: г
гавань: гавани
гадание: гадание
газета: газета
галерея: галерее галереи галерей галерея
ганновер: ганновер
германия: германии германия
год: год года годах году лет
головко: головко
город: город города городе
городницкий: городницкий
городской: городской
горожанин: горожане
гороховый: гороховой
госкаталог: госкаталог
гостинка: гостинка гостинке
гостиный: гостиный
государственный: государственный государственных
гравюра: гравюры
гражданство: гражданство
график: график
графика: графика графики графикой
григорьянц: григорьянц
грубый: грубого
группа: группа группу группы
групповой: группового групповой групповые
гтг: гтг
гуща: гуще
далее: д
данилевский: данилевский
дата: дата
двое: двоих
двор: двор
дворец: дворец
дед: дед
действовать: действовать
декабрь: декабря
день: дню
держать: держат
деталь: детали
детство: детства
деформация: деформация
деятельность: деятельности деятельностью
дмитрий: дмитрий дмитрия
добавить: добавить
добиться: добиться
дом: домов
домик: домик домики
дополнительный: дополнительные
досочинять: досочинять
доступный: доступен
др: др
другой: других
дхш: дхш
дягилев: дягилева
егоровский: егоровский егоровским егоровского
ежегодный: ежегодная
ещё: ещё
жанр: жанр
живой: живые живых
живопись: живописью
жить: живёт
журнал: журнал
заглавный: заглавная
закончить: закончен
зал: зал зала зале
замок: замка замке замок
запись: запись
заполнить: заполнить
зарегистрировать: зарегистрированный
заявление: заявление
знак: знак
зональный: зональная
игра: игра
идеология: идеология
избранный: избранные
известный: известный
изд: изд
изображение: изображения изображениями
изобразительный: изобразительного
изобрести: изобретённой
ил: ил
имя: имени имя имён
инструмент: инструменты
искусство: искусств искусства искусством
использование: использования
использовать: использующие
история: истории история
источник: источник
италия: италии италия
июль: июль июля
июнь: июнь июня
кабаре: кабаре
каждый: каждой
казаться: кажется
канада: канады
карандаш: карандаши
картина: картине
картинка: картинки
картон: картона
карточка: карточкой
каталог: каталог
категория: категории
кафе: кафе
квартира: квартире
кино: кино
киноработа: киноработ
кинофестиваль: кинофестивале
кирика: кирик
климов: климова
клуб: клуб клуба
ключ: ключ
книга: книг книги
книжный: книжная
код: код
кодекс: кодекс
коллегия: коллегия
коллекция: коллекции коллекцию
коломна: коломна коломне коломны
колорит: колоритом
конокотина: конокотина
конфиденциальность: конфиденциальности
концертный: концертный
кончаться: кончаются
копия: копия
корея: кореи
короткий: короткий
корреспондент: корреспондент
который: который
кофейный: кофейной кофейный
крепко: крепко
круг: кругах
кук: куки
культура: культуры
культурный: культурный
курорт: курорт
курортный: курортного
кустодиевый: кустодиева
лавр: лавра
лан: лана
ленинград: ленинград ленинграда ленинграде
лермонтов: лермонтова
летие: летие летию
летний: летнему летний
лист: листы
литературно: литературно
литография: литография
лицензия: лицензии
лосха: лосх лосха
лху: лху
любитель: любитель
любой: любой
м: м
май: май
манеж: манеж
марков: марков маркова
март: март марта
мастер: мастером
мастерская: мастерской
материал: материал
матисс: матисс
матёрый: матера
маяк: маяка
мебель: мебель
мегаполис: мегаполиса
медиафайл: медиафайлы
межсезонье: межсезонье
мелкий: мелкие
место: место
министерство: министерства министерство
мир: мир мира
михайлуц: михайлуца
многий: многих
множество: множестве
мобильный: мобильная
модель: модель
молодой: молодые молодым
молодость: молодость
молодёжный: молодёжная
молодёжь: молодёжь
монополь: монополи
москва: москва
московский: московских
мочь: могут
музей: музее музей музея
музейный: музейные музейных
мы: нами
мыс: мыс мыса
мюнхен: мюнхене
н: н
навигация: навигации навигация
наить: наив
направить: направить
направление: направлении
нарва: нарва
нарвский: нарвском
наслать: нашли
настоящий: настоящее
настя: насти
натюрморт: натюрморт
наука: наук
научный: научная
находиться: находятся
начальный: начальное
наш: наш наши
нвз: нвз
невский: невская
недоступный: недоступная
некоммерческий: некоммерческой
немецкий: немецкий
неоднозначный: неоднозначной
неожиданно: неожиданно
неопр: неопр
неофициальный: неофициального неофициальных
непредсказуемый: непредсказуемой
нерабочий: нерабочими
нервный: нервна
николай: николай
николо: николо
новый: новой новые новых
норвегия: норвегии
носить: носит
ноябрь: ноябрь ноября
нтв: нтв
нужно: нужно
ныне: ныне
оба: обе
обработать: обработанные
образ: образом
образование: образование
образовать: образовал
образоваться: образовалась
обратный: обратном
обращение: обращения
обсуждение: обсуждение
общество: общества общество
общий: общего
объединиться: объединиться
объект: объекты
однако: однако
окружение: окружение
октябрь: октябрь октября
олег: олегом
онфлера: онфлер
описание: описание
организация: организации
орерра: орерра
оригинал: оригинала
орудие: орудием орудия
основатель: основатель
основной: основной
особенно: особенно
особенность: особенности
особый: особое особой
остров: остров
острый: остра
ответственность: ответственности
отдел: отдел
отделение: отделении
отдельно: отдельно
отдельный: отдельных
отказ: отказ
отмечать: отмечает
отредактировать: отредактирована
официальный: официальный
охта: охте
ошибка: ошибке
п: п
павильон: павильон
палитра: палитра
параллель: параллели
параллельно: параллельно
парыгин: парыгин
пастелист: пастелистов
пастель: пастель
пастельный: пастельное пастельной
патологоанатом: патологоанатом
пейзаж: пейзаж
пейзажист: пейзажистов
первый: первый
передать: передан
перейти: перейти
перестройка: перестройке
персоналия: персоналии
персональный: персональная персональные
петербург: петербург петербурга петербурге
петербургский: петербургский петербургским петербургских петербургского петербургское
печать: печати печать
пинакотека: пинакотеке
плюс: плюс
победа: победы
поведение: поведения
повлиять: повлиял
подробный: подробнее
пожертвовать: пожертвовать
позволять: позволяет позволяют
поиск: поиск поиску
политика: политика
получить: получил получить
посвятить: посвящённая
последний: последний
постоянный: постоянная
править: править
правка: правки
практически: практически
превратить: превращённые
предмет: предметы
представить: представили
представиться: представились
представлять: представляет
применение: применение
пример: пример
примечание: примечания
приобретение: приобретение
причудливый: причудливым
причём: причём
провести: проведённого
проект: проект проекта проектах проекты
произведение: произведений
прорабатывать: прорабатывать
просмотр: просмотры
пространство: пространства
противостояние: противостоянии
профессия: профессии
профтехобразование: профтехобразования
проходить: проходила
прочитать: прочитать
прошлое: прошлое
работа: работах работе работы
работать: работает
разнообразный: разнообразные
разработчик: разработчики
район: района
рамка: рамках
расписной: расписная
рассказ: рассказа
растение: растений
реализм: реализм
редкий: редких
реставратор: реставратора
реставрация: реставрации
робинсон: робинсон
родиться: род родившиеся родился
рождение: рождения
росбалт: росбалт
российский: российские российский российского российской
россия: россии россия
рсфср: рсфср
рукопись: рукописей
русский: русская русский русского русской
русско: русско
русый: рус
рф: рф
рюген: рюген
ряд: ряда ряде
сад: сад
сайт: сайт сайте
самый: самые
сан: сан
санкт: санкт
сведение: сведения
свежий: свежие
светлый: светлому
свечной: свечном
свободный: свободной свободном
свой: своей своим свой своё
свойство: свойство
связанный: связанной связанные
связаться: свяжитесь
северюхин: северюхин
сегодня: сегодня
сектор: сектор
семья: семье
сентябрь: сентябрь сентября
серов: серова
сестрорецк: сестрорецк
сила: силы
симбиоз: симбиозом
синоним: синонимы
система: системе
систербек: систербеке
сказать: сказать
скальпель: скальпеля
скачать: скачать
скрытый: скрытые
скульптура: скульптуры
слепышева: слепышевой
служебный: служебные
случай: случаях
случайный: случайная
смотреть: см
собака: собака
собрание: собраниях
собраниять: собранияй
событие: событие события
советский: советский советскую
совместный: совместная совместных
современник: современников
современный: современного современных
содержание: содержание
содружество: содружестве
создать: создали создать
созидание: созидания
солярис: солярис
сон: сны
сообщество: сообщество
сообщить: сообщить
состав: состав
сохранение: сохранением
соцреализм: соцреализму
сочетание: сочетании
сочетать: сочетает
союз: союз союза союзов
спб: спб
специальный: специальным
справка: справка
спустя: спустя
среда: среды
ссср: ссср
ссылка: ссылка ссылками ссылки ссылок
сталкер: сталкер
стараться: старалась
старое: старого
старый: старая старой старом старый
статистика: статистика
стать: ставшее ставшей статей
статья: статьи статья
степень: степени
стиль: стиль стиля
сторона: стороны
страна: страны
страница: страница странице страницу страницы
субъективность: субъективность
сумеречный: сумеречным
существо: существ
существовать: существовала
сша: сша
сюда: сюда
таганка: таганке
таганский: таганская
так: т
также: также
талант: талантов
таллинн: таллинн таллинне
тарковский: тарковского
творческий: творческих творческого
творчество: творчестве творчество
текст: текст
текущий: текущие
телеканал: телеканале
техас: техас
техника: технике
товарищество: товарищество
товарный: товарный
торнабуонить: торнабуони
торнебуонить: торнебуони
третьяковский: третьяковской
тэие: тэии
узнавать: узнаваемы
указание: указанием
указать: указан
улица: улица
университет: университет
условие: условий условия
устремиться: устремилась
участие: участие
участник: участников
училище: училища училище
учиться: учился
учёба: учёба учёбу
учётный: учётную
фактура: фактуры
факультет: факультете
фантастический: фантастический фантастического
февраль: февраль февраля
федерация: федерации
фестиваль: фестивале фестиваль
фетиш: фетиши
филипп: филиппов
филиппов: филипповым
фильм: фильмов
фио: фио
флоренция: флоренция
фонд: фонд
фонтанка: фонтанке
формат: формате
формировать: формирует
форум: форум
фото: фото
фотограф: фотограф
франция: франции франция
х: х
характерный: характерное
холст: холсте
хотеться: хочется
хотя: хотя
художественный: художественного художественное художественном
художник: художник художника художники художников художником
хх: хх
хэппи: хэппи
цв: цв
цвз: цвз
ценный: ценное
центр: центр центре
центральный: центральном центральный
церковь: церкви
цитировать: цитировать
чайный: чайный
частный: частных
человек: люди человека
читать: читать
член: член членов члены
чувство: чувство
шаблон: шаблоном
швеция: швеции
школа: школа
шотландия: шотландии
экспериментальный: экспериментального
экспо: экспо
экспозиция: экспозиция
экспорт: экспорт
элемент: элемент
эндом: эндом
энциклопедия: энциклопедии энциклопедия
эпоха: эпоху
эрмитаж: эрмитажа
эстония: эстония
это: это
этот: эта этих
ю: ю
юбилей: юбилею
юбилейный: юбилейная
южный: южной
юный: юных
яани: яани
язык: язык языках
ян: ян яна
январь: январь января
яркий: яркий
