авторство: авторства
академия: академии
алтарь: алтарь
алфавит: алфавиту
альвара: альвар
альфред: альфред
ассоциация: ассоциации
бельгия: бельгия
библиографический: библиографических
биография: биография
больший: большая
бретань: бретань
вд: вд
век: века
великое: великое
вернуться: вернулся
версия: версия
викидать: викиданных
викимедиа: викимедиа
википедия: википедии википедия
викисклад: викисклад викискладе
вклад: вклад
внешний: внешние
война: войны
войти: войти
вып: вып
выпускник: выпускники
выставка: выставка
г: г
галерея: галерея
год: год года году лет
группа: группы
губерния: губерния
дания: дании
дата: дата
действовать: действовать
день: день
деятель: деятелей деятели
деятельность: деятельности
дидрихсен: дидрихсена
дополнительный: дополнительные
доступный: доступен
другой: других
европейский: европейских
ещё: ещё
жениться: женился
заглавный: заглавная
запись: запись
заполнить: заполнить
зарегистрировать: зарегистрированный
затем: затем
заявление: заявление
збекча: збекча
знак: знак
избранный: избранные
известный: известных
изображение: изображениями
изобразительный: изобразительного изобразительных
изящный: изящных
империя: империя
имя: имён
инструмент: инструменты
искусство: искусств искусства искусством
испания: испании испанию
использование: использования
история: история
источник: источник источниками
италия: италии италия
июнь: июня
кавена: кавене
кавено: кавен
картина: картин
каталог: каталогах
категория: категории
кладбище: кладбище
княжество: княжество
код: код
кодекс: кодекс
коллекция: коллекции
конфиденциальность: конфиденциальности
короткий: короткий
корпилахти: корпилахти
который: которая
коттета: коттета
кубист: кубистов
кук: куки
куусанкосок: куусанкоски
лапинлахти: лапинлахти
лицензия: лицензии
март: марта
материал: материал
медиафайл: медиафайлы
место: место
мировой: мировой
мобильный: мобильная
мочь: могут
музей: музей музея
музыка: музыкой
музыкант: музыкант
мы: нами
мянттить: мянття
навигация: навигации навигация
национальный: национальная
некоммерческий: некоммерческой
нидерл: нидерл
нидерланды: нидерланды
новый: новые
норвежский: норвежская
ноябрьский: ноябрьской
нська: нська
образование: образование
обсуждение: обсуждение
общество: общества
объединять: объединявшей
октябрь: октября
описание: описание
организация: организации
основатель: основателей
ответственность: ответственности
отдельный: отдельных
отказ: отказ
откуда: откуда
отправиться: отправился
отредактировать: отредактирована
ошибка: ошибке
париж: париж париже
пасмурный: пасмурный
пейзаж: пейзаж
пейзажист: пейзажисты
первый: первая первой
перейти: перейти
персоналия: персоналии
персональный: персональные
печать: печати печать
побывать: побывав
поведение: поведения
подпись: подписи
подробный: подробнее
пожертвовать: пожертвовать
поиск: поиск поиску
политика: политика
получить: получил получить
портретист: портретисты
посетить: посетил
последний: последний
постоянный: постоянная
похоронить: похороненные
похоронный: похоронен
править: править
правка: правки
председатель: председателем председатель
представиться: представились
преподавать: преподавал
примечание: примечания
продолжать: продолжала
продолжить: продолжил
проект: проектах
просмотр: просмотры
пространство: пространства
путешествие: путешествие
работа: работ
рагнуть: рагни
разработчик: разработчики
ресурс: ресурсы
рисование: рисования
рисовать: рисовать
родиться: род родившиеся родился
рождение: рождения
российский: российская
русский: русский русской
ряд: ряд
саймон: саймона
сайт: сайты
сведение: сведения
свежий: свежие
свободный: свободной
свойство: свойство
связанный: связанные
связаться: свяжитесь
семья: семье
симпеле: симпеле
система: системе
скачать: скачать
скрытый: скрытые
слепой: слепой
словарь: словари
служебный: служебные
случай: случаях
случайный: случайная
смерть: смерти
смотреть: см
событие: события
совершить: совершил
современный: современного
содержание: содержание
создать: создать
сообщество: сообщество
сообщить: сообщить
состояться: состоялась
сохранение: сохранением
справка: справка
среди: среди
ссылка: ссылка ссылками ссылки
статистика: статистика
стать: стал
статья: статьи статья
страна: стран страна
страница: страница странице страницу страницы
студия: студии
супруг: супруга
сюда: сюда
тавастгусский: тавастгусская
так: т
текст: текст
текущий: текущие
тематический: тематические
товарный: товарный
увлекаться: увлекавшейся
указание: указанием
укра: укра
умереть: умер
умерший: умершие
условие: условий условия
участие: участие
учёба: учёбу
учётный: учётную
фамилия: фамилией
фин: фин
финляндия: финляндии финляндия
финляндский: финляндское
финский: финский финских финского
фонд: фонд
форум: форум
франс: франс
франция: франции франция
хельсинки: хельсинки
хиетаниеметь: хиетаниеми
храниться: хранится
художественный: художественного художественное
художник: художник художника художники художников
художница: художнице
центральный: центральной
церковь: церквей
цитировать: цитировать
человек: людях
число: числе
читать: читать
член: член членом члены
швеция: швеция
школа: школе
экспорт: экспорт
экспрессионист: экспрессионистов экспрессионисты
элемент: элемент элементы
энциклопедия: энциклопедии
эспоо: эспоо
этот: эта
язык: языках
