авторство: авторства
албанский: албанскую
александракис: александракиса
александракиснуть: александракис
александрос: александрос
алфавит: алфавиту
альбом: альбом
английский: английском
аргироса: аргироса
артиллерия: артиллерии
афинский: афинская афинскую
афины: афинах афины
афиша: афишах
баталист: баталисты
библиотека: библиотекой
биография: биография
брат: братьев
братство: братством
век: века
версия: версия
викатос: викатоса
викидать: викиданных
викимедиа: викимедиа
википедия: википедии википедия
вклад: вклад
воевать: воевали воюя
возраст: возрасте
война: война войны
войти: войти вошли
волшебный: волшебные
впечатление: впечатления
выйти: вышедший
высокий: высшую
выставка: выставках выставке выставки выставку
г: г
галерея: галереей галерея
го: го
год: года годах году лет
гора: горах
гравёр: гравера
гражданство: гражданство
граница: границу
греция: греции греция
греча: греч
греческий: греческая греческий греческом
групповой: групповой
грёкий: греко
гуггенхайм: гуггенхайма
дар: дар
дата: дата
действовать: действовать
детство: детстве
деятельность: деятельности
динамичный: динамичными
дополнительный: дополнительные
доступный: доступен
другой: других
ещё: ещё
живопись: живописи
заглавный: заглавная
заголовок: заголовком
запись: запись
зарегистрировать: зарегистрированный
заснеженный: заснеженных
заявление: заявление
звание: звании
знак: знак
избранный: избранные
известность: известность
известный: известен известный
издать: издана
изящный: изящных
иллюстрация: иллюстрация
имя: имён
инструмент: инструменты
искусство: искусств
использование: использования
использовать: использованы использующие
история: история
источник: источник источниками
италый: итало
итальянский: итальянской
июнь: июня
капрал: капрала
картина: картин картинами
категория: категории
кефаллинос: кефаллиноса
кипр: кипр
класс: класса классы
код: код
кодекс: кодекс
конфиденциальность: конфиденциальности
короткий: короткий
кук: куки
литература: литература
лицензия: лицензии
лондонский: лондонской
материал: материал
место: место
многие: многие
многий: многих
мобилизовать: мобилизованы
мобильный: мобильная
молодёжный: молодёжным
мочь: могут
музей: музеем
мы: нами
навигация: навигации навигация
национальный: национальная
начало: началом
начальный: начальной
начать: начал
некоммерческий: некоммерческой
немецкий: немецком
никосия: никосии
новый: новые
обнажённый: обнажённое
обсуждение: обсуждение
около: около
окончание: окончании
окончить: окончил
октябрь: октября
описание: описание
организация: организации
организовать: организовала организованной организованы
ответственность: ответственности
отдельный: отдельных
отказ: отказ
отобразить: отобразил
отредактировать: отредактирована
ошибка: ошибке
перейти: перейти
персоналия: персоналии
персональный: персональные
печать: печати печать
пинд: пинд
поведение: поведения
подробный: подробнее
пожертвовать: пожертвовать
поздний: позже
поиск: поиск поиску
политика: политика
получить: получивших получить
поручить: поручена
посещать: посещал
послать: посланы
последний: последний
постоянный: постоянная
поступить: поступив
править: править
правка: правки
предел: пределами
представиться: представились
примечание: примечания
принимать: принимал
проект: проектах
просмотр: просмотры
пространство: пространства
проявиться: проявился
работа: работ работами
различный: различных
разработчик: разработчики
расширение: расширение
ретроспектива: ретроспективу
рисунок: рисунков
родиться: род родившиеся родился
рождение: рождения
русский: русский
ряд: ряде
сведение: сведения
свежий: свежие
свободный: свободной
свой: свои своими
связанный: связанные
связаться: свяжитесь
сенат: сената
система: системе
скачать: скачать
скрытый: скрытые
служебный: служебные
случай: случаях
случайный: случайная
смерть: смерти
смотреть: см
событие: события
содержание: содержание
создать: создать
соломон: соломона
сообщество: сообщество
сообщить: сообщить
сотрудничество: сотрудничество
сохранение: сохранением
спиридон: спиридона
справка: справка
сразу: сразу
ссылка: ссылка ссылки
статистика: статистика
стать: стал стало
статья: статьи статья
страница: страница странице страницу страницы
сша: сша
сюда: сюда
также: также
текст: текст
текущий: текущие
тело: тело
тема: темой
товарный: товарный
указание: указанием
умвертос: умвертоса
умереть: умер
умерший: умершие
условие: условий условия
участвовать: участвовал
участие: участие
учебник: учебника
учиться: учился
учёба: учёба
учётный: учётную
фонд: фонд
форум: форум
французский: французском
христианский: христианским
художественный: художественный
художник: художник художника художники художников
цитировать: цитировать
человеческий: человеческое
читать: читать
широкий: широкую
школа: школа школу школы
экспорт: экспорт
элемент: элемент
энциклопедия: энциклопедии
эпир: эпир
этот: эта
язык: языках
яннис: янниса
