август: августа
авторство: авторства
академик: академик академика академиком
академия: академии академию академия
акрополь: акрополь
алфавит: алфавиту
арзуман: арзуманов
арзуманидис: арзуманидис
архипович: архипович
аттестационный: аттестационной
биография: биография
бородино: бородино
ваяние: ваяния
век: века
версия: версия
викидать: викиданных
викимедиа: викимедиа
википедия: википедии википедия
вклад: вклад
войти: войти
выпускник: выпускники
высокий: высшей
г: г
галерея: галереи
год: года году годы лет
гора: гора
государственный: государственного государственной
греческий: греческого
грсср: грсср
грузия: грузии
дата: дата
действительный: действительные
действовать: действовать
декоративный: декоративное
деятель: деятели
деятельность: деятельность
диарамный: диарамно
дизайн: дизайна
дизайнер: дизайнер
добавить: добавить
доктор: доктор доктора
донской: донского
дополнительный: дополнительные
доступный: доступен
другой: других
ещё: ещё
женитьба: женитьба
живописец: живописец
живописный: живописные
живопись: живописи
заглавный: заглавная
заместитель: заместитель
запись: запись
зарегистрировать: зарегистрированный
заявление: заявление
звание: звания
знак: знак
зодчество: зодчества
иван: ивана
избранный: избранные
избрать: избран
изобразительный: изобразительного
имя: имя имён
инструмент: инструменты
интерьер: интерьеров интерьеру
искусство: искусств искусства
использование: использования
история: история
источник: источник
июнь: июня
картина: картиной
категория: категории
квалификация: квалификации
код: код
кодекс: кодекс
коллекция: коллекциях
комбинат: комбинат
комиссия: комиссии
конфедерация: конфедерации
конфиденциальность: конфиденциальности
короткий: короткий
кук: куки
литвинский: литвинского
лицензия: лицензии
львовский: львовская львовской львовскую
май: мая
макетный: макетных
материал: материал
международный: международной
место: место
мобильный: мобильная
море: море
морской: морской
москва: москва москве
московский: московского
мочь: могут
музей: музеях
мы: нами
навигация: навигации навигация
натюрморт: натюрморт
находиться: находятся
национальный: национальная национальной национальную
некоммерческий: некоммерческой
неопр: неопр
николаев: николаева
новый: новые
обращение: обращения
обсуждение: обсуждение
окончить: окончил
олимп: олимп
описание: описание
организация: организации организаций
основной: основные
ответственность: ответственности
отделение: отделения
отдельный: отдельных
отказ: отказ
отредактировать: отредактирована
оформление: оформление
ошибка: ошибке
п: п
павел: павел
павлос: павлос
палеолог: палеолог
память: память
пейзаж: пейзаж
перейти: перейти
персоналия: персоналии
персональный: персональные
печать: печати печать
поведение: поведения
повышение: повышения
подробный: подробнее
пожертвовать: пожертвовать
поиск: поиск поиску
политика: политика
получить: получить
портрет: портрет
последний: последний
постоянный: постоянная
почётный: почётные почётный
править: править
правка: правки
председатель: председатель председателя
представиться: представились
президент: президент
проект: проект проектах проекты
произведение: произведения
просмотр: просмотры
пространство: пространства
профессор: профессор профессора
профсоюзный: профсоюзной
работа: работ работа работы
разработчик: разработчики
рах: рах
ргс: ргсу
ритон: ритоном
родиться: родившиеся родился
рождение: рождении рождения
российский: российский российского российской
россия: россии россия
рсфср: рсфср
рубеж: рубежом
руководитель: руководитель
русский: русский
русско: русско
сарианиди: сарианиди
сарт: сарт
сведение: сведения
свежий: свежие
свободный: свободной
связанный: связанные
связаться: свяжитесь
сентябрь: сентября
система: системе
скачать: скачать
служебный: служебные
случай: случаях
случайный: случайная
смерть: смерти
смотреть: см
событие: события
содержание: содержание
создать: создать
сообщество: сообщество
сообщить: сообщить
софия: софии
сохранение: сохранением
социальный: социального
союз: союза союзов
справка: справка
ссср: ссср
ссылка: ссылка ссылки
статистика: статистика
статья: статьи статья
страна: страна
страница: страница странице страницу страницы
сюда: сюда
творческий: творческая творческих творческого
текст: текст
текущий: текущие
технический: технического
товарный: товарный
указание: указанием
умереть: умер
умерший: умершие
университет: университета университете
условие: условий условия
участие: участие
учёба: учёба
учётный: учётную
факультет: факультет
фамилия: фамилией
федеральный: федеральном
фонд: фонд фонда
форум: форум
фрукт: фруктами
художественно: художественно
художественный: художественного художественных
художество: художеств
художник: художник художника художники художников
цдх: цдх
цитировать: цитировать
частный: частных
человек: людях
читать: читать
член: член члены
шириний: шириния
школа: школы
эгейский: эгейское
экспорт: экспорт
элемент: элемент
энциклопедия: энциклопедии
этот: эта
ю: ю
южный: южном
язык: языках
