август: августа
автор: автором
авторство: авторства
агентство: агентство
айвазян: айвазян айвазяна
академия: академии
алфавит: алфавиту
английский: английский
арарат: арарат
арма: арм
армения: армении
армянский: армянская армянских армянского армянское армянской
архивировать: архивировано
аршить: аршил
аэропорт: аэропорту
беларускать: беларуская
биография: биография
век: века
великобритания: великобритании великобритания
версия: версия
весна: весна
викидать: викиданных
викимедиа: викимедиа
википедия: википедии википедия
викисклад: викисклад викискладе
вклад: вклад
внешний: внешние
внутренний: внутренних
возраст: возрасте
войти: войти
всесоюзный: всесоюзного
встреча: встреча
выпустить: выпущен
выставка: выставка выставках выставки
г: г
галерея: галерея
гилдхолл: гилдхолл
год: год года году лет
горка: горки
горький: горького
гражданство: гражданство
графический: графических
групповой: групповая групповых
гулбенкян: гулбенкян
давид: давид
дата: дата
действовать: действовать
деревня: деревня
деятель: деятели
деятельность: деятельности
диаспора: диаспоры
дополнительный: дополнительные
доступный: доступен
друг: другом
другой: других
европа: европе
ежегодный: ежегодная
ереван: ереван
ещё: ещё
жительство: жительства
завоевать: завоевал
заглавный: заглавная
зал: зал
запись: запись
заполнить: заполнить
зарегистрировать: зарегистрированный
заявление: заявление
знак: знак
избранный: избранные
известный: известных
изображение: изображениями
изобразительный: изобразительного
изучать: изучал
имя: имён
индивидуальный: индивидуальных
инструмент: инструменты
интерьер: интерьеров
инфекция: инфекции
информационный: информационное
иран: иран ирана иране
иранский: иранский иранскими
искусство: искусства
использование: использования
история: история
источник: источник
исфахан: исфахане
италия: италии
йорк: йорк
каллиграфический: каллиграфический
канада: канада
картина: картин
категория: категории
клуб: клуб клубе
код: код
кодекс: кодекс
комитасу: комитасу
конкурс: конкурсе
конфиденциальность: конфиденциальности
кончаться: кончался
король: король
коронавирусный: коронавирусной
короткий: короткий
коснуться: коснулся
который: котором
кроме: кроме
кук: куки
культура: культуру культуры
культурный: культурных
лицензия: лицензии
лондон: лондон лондоне
март: марта
материал: материал
медаль: медаль медалью
медиафайл: медиафайлы
международный: международном
местный: местной
место: место
метровый: метровый
министерство: министерства министерством
многий: многих
множество: множество
мобильный: мобильная
мой: моим
молодой: молодые
морской: морских
мочь: могут
музей: музеях
мурадян: мурадяна мурадяном
мы: нами
навигация: навигации навигация
награда: награды
наградить: награждён
название: названием
находиться: находятся
национальный: национальная
некоммерческий: некоммерческой
неопр: неопр
новый: новые
нью: нью
образование: образования
обсуждение: обсуждение
общество: общества
ованес: ованеса
один: одной
описание: описание
организация: организации
основной: основные
ответственность: ответственности
отдельный: отдельных
отказ: отказ
открыться: открылись
отправиться: отправился
отредактировать: отредактирована
ошибка: ошибке
пейзаж: пейзажей
первый: первую
переехать: переехал
перейти: перейти
персидский: персидскую
персидско: персидско
персоналия: персоналии
персональный: персональная персональные
печать: печати печать
поведение: поведения
подробный: подробнее
пожертвовать: пожертвовать
поиск: поиск поиску
политика: политика
получить: получил получить
портрет: портретов
посвятить: посвященная посвящённый
последний: последний
постоянный: постоянная постоянное
править: править
правка: правки
представиться: представились
премия: премию
примечание: примечания
присуждать: присуждаемую
продолжение: продолжения
проект: проектах
произведение: произведения
проиллюстрировать: проиллюстрировал
происхождение: происхождения
просмотр: просмотры
пространство: пространства
проучиться: проучился
проявиться: проявилась
пустой: пуст
ра: ра
работа: работ работах работы
различный: различных
разместить: размещены
разработчик: разработчики
расположить: расположенный
рим: рим
рисование: рисованию
риядскома: риядском
родина: родины
родиться: род родившиеся родился
рождение: рождения
российско: российско
русский: русский
ряд: ряда
самый: самых
саргиса: саргиса
саргисом: саргисом
сасунский: сасунский
сведение: сведения
свежий: свежие
свет: свет
свободный: свободной
свой: своих
свойство: свойство
связанный: связанные
связаться: свяжитесь
связь: связей
святой: святого
семья: семье
сентябрь: сентября
система: системе
скачать: скачать
скрытый: скрытые
служебный: служебные
случай: случаях
случайный: случайная
смерть: смерти
смотреть: см
собор: собора
событие: события
современный: современными современных
содержание: содержание
создать: создал созданный создать
сообщество: сообщество
сообщить: сообщить
сохранение: сохранением
союз: союз союза
справка: справка
ссылка: ссылка ссылки
статистика: статистика
статья: статьи статья
страница: страница странице страницу страницы
сша: сша
сюда: сюда
тегеран: тегеран тегеране
текст: текст
текущий: текущие
тематика: тематике
товарный: товарный
туманян: туманяна
тяга: тяга
указание: указанием
указать: указан
умерший: умершие
условие: условий условия
участие: участие
учётный: учётную
фамилия: фамилией
фестиваль: фестиваль
фонд: фонд
форум: форум
фотоальбом: фотоальбом
фриз: фриз
халид: халид
холл: холл
художественный: художественном
художество: художеств
художник: художник художника художниками художники художников
цвет: цвета
цель: целью
церковь: церквей церквях
цикл: цикл
цитировать: цитировать
частность: частности
человек: люди людях
читать: читать
шаблон: шаблон
эдман: эдман
эдмана: эдмана
экспонироваться: экспонировался
экспорт: экспорт
элемент: элемент
энциклопедия: энциклопедии
эпос: эпоса
эра: эр
этот: эта
являться: является
язык: язык языках
