авторство: авторства
алфавит: алфавиту
антип: антипов
артпанорама: артпанорама
белый: белом
берлин: берлине
биография: биографии
брно: брно
брюссель: брюсселе
бюро: бюро
варшава: варшаве
век: века
версия: версии версия
викидать: викиданных
викимедиа: викимедиа
википедия: википедии википедия
вклад: вклад
войти: войти
всероссийский: всероссийском
выставка: выставки выставок
галерея: галерея
год: года году годы
государственный: государственном
дата: дата
действовать: действовать
декоративный: декоративно декоративной декоративные
дер: дер
деятель: деятели
деятельность: деятельность
добавить: добавить
дополнительный: дополнительные
доступный: доступен
другой: других
ещё: ещё
жанр: жанр
жена: жена
живопись: живописи
жостовский: жостовская жостовскую
жостовый: жостово
заглавный: заглавная
занятие: занятий
запись: запись
заповедник: заповеднике
зарегистрировать: зарегистрированный
заслужить: заслуженные заслуженный
заявление: заявление
звание: звания
знак: знак
избранный: избранные
избрать: избран
изменение: изменения
измир: измире
изображение: изображений
изобразительный: изобразительного
имя: имён
инкрустация: инкрустациями
инструмент: инструменты
искусство: искусства
использование: использования
история: история
источник: источник
истра: истра
июль: июля
категория: категории
код: код
кодекс: кодекс
конфиденциальность: конфиденциальности
корзина: корзине
короткий: короткий
краеведческий: краеведческом
кук: куки
лицензия: лицензии
марина: марина
мастер: мастер
материал: материал
место: место
милан: милане
мобильный: мобильная
монреаль: монреале
москва: москва
московский: московская
мочь: могут
музей: музее
мы: нами
мытищинский: мытищинский мытищинском
навигация: навигации навигация
награда: награды
народный: народного народные народный
натюрморт: натюрморты
находиться: находится
начаться: началась
некоммерческий: некоммерческой
неопр: неопр
николай: николай
новый: новые
областной: областном
область: область
обращение: обращения
обсуждение: обсуждение
ожидать: ожидают
окончить: окончил
октябрь: октября
описание: описание
организация: организации
орнаментальный: орнаментальный
осака: осаке
основной: основные
ответственность: ответственности
отдельный: отдельных
отказ: отказ
отредактировать: отредактирована
ошибка: ошибке
перейти: перейти
перламутровый: перламутровыми
персоналия: персоналии
персональный: персональные
петербург: петербурге
петрович: петрович
печать: печати печать
пловдив: пловдиве
поведение: поведения
поднос: подносы
подробный: подробнее
пожертвовать: пожертвовать
поиск: поиск поиску
политика: политика
получить: получить
посад: посад
последний: последний
постоянный: постоянная
править: править
правка: правки
представиться: представились
прикладной: прикладного
проверить: проверена
проверка: проверки
продолжать: продолжают
проект: проектах
просмотр: просмотры
пространство: пространства
профтехникум: профтехникум
работа: работа работы
работать: работая
разработчик: разработчики
район: район районе
рапсодия: рапсодия
рисовать: рисуют
родиться: род родившиеся
рождение: рождения
роза: розы
роспись: росписи роспись
российский: российский российской
россия: россии россия
рсфср: рсфср
русский: русский русском
санкт: санкт
сведение: сведения
свежий: свежие
свободный: свободной
связанный: связанные
связаться: свяжитесь
секция: секции
семейный: семейную
сергиев: сергиев
система: системе
сиэтл: сиэтле
скачать: скачать
скрытый: скрытые
служебный: служебные
случай: случаях
случайный: случайная
смотреть: см
событие: события
советский: советский
современник: современников
содержание: содержание
создавать: создавал
создать: создать
сообщество: сообщество
сообщить: сообщить
сохранение: сохранением
союз: союза
справка: справка
ссср: ссср
ссылка: ссылка ссылки
стабильный: стабильная
статистика: статистика
статья: статьи статья
страна: страна
страница: страница странице страницу страницы
сын: сын
сюда: сюда
также: также
творческий: творческая
текст: текст
текущий: текущая текущие
тип: тип
товарный: товарный
традиция: традицию
указание: указанием
уникальный: уникальные
условие: условий условия
участие: участие
участник: участник
учётный: учётную
фамилия: фамилией
февраль: февраля
федерация: федерации
фонд: фонд
форум: форум
художественный: художественная художественные
художник: художник художники художников
цветок: цветы
цветочный: цветочная
цитировать: цитировать
человек: людях человек
читать: читать
член: член членом члены
шаблон: шаблонов
школа: школа
экспорт: экспорт
элемент: элемент
энциклопедия: энциклопедии
этнография: этнографии
этот: эта
язык: языках
