авангардистский: авангардистского
авив: авив авиве
авиданиум: авиданиум
авидать: авидан авидана
автор: автор
авторство: авторства
айга: айги
айот: айот
актуализировать: актуализировали
актёр: актёр
александр: александр
алфавит: алфавиту
амалия: амалией
американский: американскую
амихая: амихаей
амихаять: амихаем
английский: английский
ангнуть: англо
антология: антология
арион: арион
аруфь: аруфей
архивировать: архивировано
архивный: архивная
ахшать: ахшав
бар: бар
бараш: бараш
бе: бе
бейнаим: бейнаим
библиографический: библиографических
билти: билти
биография: биография
благоприятный: благоприятный
близкий: близких
больший: большая
бразима: бразим
быстров: быстров
быть: будучи
бялик: бялика
век: века веков
версия: версия
взгляд: взгляды
викидать: викиданных
викимедиа: викимедиа
википедия: википедии википедия
викисклад: викисклад викискладе
викитека: викитеку
вклад: вклад
вместе: вместе
внешний: внешние
возможность: возможностей
войти: войти
волшебный: волшебные
впоследствии: впоследствии
входить: входит
выйти: вышла
выпускник: выпускники
габриэль: габриэль
геннадий: геннадий
гешарить: гешарим
год: год года годов году годы
гонорар: гонораров
гражданство: гражданство
гринберг: гринберг гринберга
группа: группе
губа: губами
давид: давид давида
далее: д
дата: дата
действовать: действовать
декабрь: декабря
деятельность: деятельности деятельность деятельностью
дополнительный: дополнительные
дором: дором
достойный: достойного
доступный: доступен
др: др
друг: друзей
другой: других
дубинский: дубинской
еврейский: еврейская еврейский еврейского еврейской
ещё: ещё
заглавный: заглавная
задача: задачу
заниматься: заниматься
запись: запись
заработок: заработка заработком
зарегистрировать: зарегистрированный
захома: захом
заявление: заявление
зеркало: зеркало
зингер: зингер зингера
знак: знак
значение: значение
зоя: зоя
ивр: ивр
иврит: иврит иврита иврите
ивритский: ивритские ивритской
иегуда: иегудой
иерусалим: иерусалим иерусалиме
избранный: избранные
издание: издания
издательство: издательстве
измениться: изменилась
израиль: израиль израиля
израильский: израильская израильский израильских
изучать: изучал
имя: имени имя имён
инструмент: инструменты
информация: информация
использование: использования
использовать: использующие
история: история
источник: источник
итог: итог
ишийот: ишийот
июль: июля
йехудой: йехудой
йосеф: йосеф
кандидат: кандидатом
канон: канон
кармона: кармон
каталог: каталогах
категория: категории
кахан: кахана
качество: качестве
киноактёр: киноактёр
кинопоиск: кинопоиск
кинорежиссёр: кинорежиссёр
киносценарист: киносценарист
китайский: китайская
ключевой: ключевых
книга: книг книга книги
код: код
кодекс: кодекс
кой: кое
конфиденциальность: конфиденциальности
копельман: копельман
копия: копия
короткий: короткий
который: которые который
кран: краны
критика: критики
критиковать: критиковали
круг: кругах
кто: кого
кук: куки
культура: культуры
лаконизм: лаконизм
лауреат: лауреатом лауреаты
ликрат: ликрат
литература: литература литературу литературы
литературный: литературная литературного литературной литературные
лицензия: лицензии
личный: личные
м: м
май: мая
малевичеанец: малевичеанец
материал: материал
медиафайл: медиафайлы
менее: менее
место: место
мобильный: мобильная
мокед: мокед
мост: мосты
мочь: могут
моше: моше
мы: нами
н: н
навигация: навигации навигация
награда: наград награды
назначение: назначении
написать: написал
наряду: наряду
натан: натаном
начало: начале началу
начать: начал
невозможный: невозможные
некод: некод некода
некоммерческий: некоммерческой
неопр: неопр
непустой: непустое
несколько: несколько
нло: нло
нобелевский: нобелевской
новый: новые
нська: нська
обманчивый: обманчивый
образование: образование
обращение: обращения
обсуждение: обсуждение
один: одним одной
октябрь: октября
описание: описание
организация: организации
основное: основном
ответственность: ответственности
отдельный: отдельных
отзыв: отзыв отзывы
отказ: отказ
отличаться: отличается
отредактировать: отредактирована
отрицательный: отрицательные
отрубить: отрубленными
ошибка: ошибке
пер: пер
первый: первая первый
перевод: переводах переводов переводы
переводить: переводил
переводческий: переводческую
переводчик: переводчик переводчиков
перейти: перейти
периодический: периодического
персоналия: персоналии
персональный: персональные
печать: печати печать
писатель: писатели писатель писателях
писать: писал
платить: платили
поведение: поведения
подробный: подробнее
пожертвовать: пожертвовать
поиск: поиск поиску
покончить: покончил
политика: политика
положительный: положительную
получение: получение
получить: получил получила получить
последний: последний
послесловие: послесловием
постоянный: постоянная
поэзия: поэзии поэзия
поэма: поэмы
поэт: поэт поэта поэтов поэты
поэтика: поэтикой
поэтический: поэтической
править: править
правка: правки
предлагать: предлагали
представиться: представились
премия: премии премия
прикладной: прикладные
применительно: применительно
примечание: примечания
проблема: проблем проблемы
проект: проектах
произведение: произведений
промежуточный: промежуточный
просмотр: просмотры
пространство: пространства пространстве
профессиональный: профессиональных
психический: психическое
публицист: публицист
радикальный: радикальной
разработчик: разработчики
ранний: ранних
расширение: расширение
редактор: редактор
режим: режиме
режиссёр: режиссёры
репутация: репутация
ресурс: ресурсы
родиться: род родившиеся родился
рождение: рождении рождения
русский: русский русских
русско: русско
савелий: савелий
сайт: сайты
самый: самых
сборник: сборник
сведение: сведения
свежий: свежие
свободный: свободной
связанный: связанные
связаться: свяжитесь
связь: связи
себя: собой
серьёзно: серьезно
сиккума: сиккум
система: системе
скачать: скачать
скрытый: скрытые
словарь: словари
служебный: служебные
случай: случаях
случайный: случайная
смерть: смерти
смотреть: см
собственный: собственные
событие: события
совместно: совместно
содержание: содержание
создать: создать
сообщество: сообщество
сообщить: сообщить
составитель: составители
состояние: состояние
состоять: состоял
сохранение: сохранением
справка: справка
сравнение: сравнению
ссылка: ссылка ссылки
статистика: статистика
стать: стал
статья: статьи статья
стих: стихи стихов
стихотворение: стихотворений
сторона: сторону
страница: страница странице страницу страницы
студент: студентом
сфатаить: сфатаим
считаться: считается
сюда: сюда
также: также
творчество: творчества
текст: текст
текущий: текущие
тель: тель
тематический: тематические
технократический: технократические
товарный: товарный
толк: толка
традиция: традицию
указание: указанием
указать: указан
укра: укра
умерший: умершие
университет: университет университета
условие: условий условия
усложнять: усложняет
ухудшиться: ухудшилось
участие: участие
учётный: учётную
фамилия: фамилией
февраль: февраля
фигура: фигур
философия: философию
фонд: фонд
форум: форум
х: х
хамуталь: хамуталь
хороший: лучших
художник: художник художники художником
цитировать: цитировать
частность: частности
человек: людях
читательский: читательском
читать: читать
шаблон: шаблон
шаус: шаус
шимушиима: шимушиим
ширить: ширим
шовинистский: шовинистские
эгоцентризм: эгоцентризм
экспорт: экспорт
электронный: электронной
элемент: элемент
энциклопедия: энциклопедии
этот: эта
эфшариима: эфшариим
язык: язык языках
яков: яков
