авангард: авангард
авторство: авторства
академия: академии
александровский: александровского
алфавит: алфавиту
альбом: альбом
андерс: андерс
андрей: андрей
архивировать: архивировано
биография: биография
васильев: васильев
век: века
версия: версии версия
викидать: викиданных
викимедиа: викимедиа
википедия: википедии википедия
виктор: виктор
вклад: вклад
вместе: вместе
войти: войти
волошин: волошин волошина волошиной волошиным
волшебный: волшебные
воспоминание: воспоминания
вступа: вступ
г: г
год: года годах году лет
гость: гостях
государственный: государственных
давыдов: давыдова
далее: д
дата: дата
движение: движения
действовать: действовать
декоративный: декоративного
день: день
деятель: деятели
деятельность: деятельности
добавить: добавить
дом: дом дома
дополнительный: дополнительные
доступный: доступен
другой: других
ещё: ещё
жена: женой
жить: жил
з: з
заболоцкий: заболоцкой
заглавный: заглавная
заключить: заключённым
занятие: занятий
запись: запись
зарегистрировать: зарегистрированный
заявление: заявление
знак: знак
значительно: значительно
избранный: избранные
известный: известные
изд: изд
изображение: изображений
изобразительный: изобразительного
ил: ил
империя: империи
имя: имён
инструмент: инструменты
исаев: исаев
искусство: искусства
использование: использования
использовать: использующие
исторический: исторический
история: история
источник: источник
кардовский: кардовского
карточка: карточки
категория: категории
каторга: каторга
каторжный: каторжных
качество: качестве
кн: кн
код: код
кодекс: кодекс
коктебель: коктебеле коктебель коктебеля
конфиденциальность: конфиденциальности
короткий: короткий
крусанов: крусанов
кук: куки
купченко: купченко
ленинградский: ленинградская
литературный: литературное
лицензия: лицензии
м: м
максимилиан: максимилиана
март: марта
мастерская: мастерских
материал: материал
мобильный: мобильная
мочь: могут
музей: музей
мы: нами
н: н
навигация: навигации навигация
назначить: назначен
написать: написал
настоящий: настоящая
находиться: находятся
некоммерческий: некоммерческой
неопр: неопр
новый: новое новые
обзор: обзор
обозрение: обозрение
обращение: обращения
обсуждение: обсуждение
объём: объемы
описание: описание
опытный: опытными
организация: организации
осудить: осуждён
ответственность: ответственности
отдел: отдела
отдельный: отдельных
отказ: отказ
отличаться: отличаться
отредактировать: отредактирована
ошибка: ошибке
п: п
панорама: панорама
параметр: параметров
партия: партии
пенза: пензе
пензенский: пензенских
перейти: перейти
персоналия: персоналии
персональный: персональные
пескова: песковой
петербургский: петербургской
печать: печати печать
платонович: платонович
поведение: поведения
подарок: подарка
подробный: подробнее
пожертвовать: пожертвовать
поиск: поиск поиску
пока: пока
политика: политика
политкаторжанин: политкаторжан политкаторжанин
получить: получить
портрет: портрет
последний: последний
поссориться: поссорился
постоянный: постоянная
поэт: поэта
правда: правда
править: править
правка: правки правок
представиться: представились
примечание: примечания
проверить: проверенной
проверка: проверки
проверяться: проверялась
проект: проектах
просмотр: просмотры
пространство: пространства
работа: работ работы
разработчик: разработчики
революционный: революционного революционной
революция: революция
родиться: род родившиеся
рождение: рождения
российский: российской
руководитель: руководителем
русский: русский
самара: самаре
сведение: сведения
свежий: свежие
свободный: свободной свободных
связанный: связанные
связаться: свяжитесь
сентябрь: сентября
симферополь: симферополь
система: системе
скачать: скачать
скрытый: скрытые
служебный: служебные
случай: случаях
случайный: случайная
смерть: смерти
смотреть: см
собрание: собраниях
событие: события
советский: советский
современник: современников
содержание: содержание
создать: создать
сокровище: сокровища
соната: сонат
сообщество: сообщество
сообщить: сообщить
сохранение: сохранением
справка: справка
ссср: ссср
ссылка: ссылка ссылки
ст: ст
статистика: статистика
статья: статьи статья
стихотворение: стихотворения
стр: стр
страна: страна
страница: страница странице страницу страницы
сюда: сюда
так: т
текст: текст
текущий: текущая текущие
тип: тип
товарный: товарный
требовать: требуют
уехать: уехал
узнавать: узнаю
указание: указанием
умерший: умершие
условие: условий условия
участвовать: участвовал
участие: участие
участник: участник участниками
учиться: учился
учётный: учётную
фамилия: фамилия фамилиями
фонд: фонд
форум: форум
фотография: фотографии
футуристический: футуристическая
художественный: художественных
художество: художеств
художник: художник художники
централ: централа
цитировать: цитировать
человек: людях человек
черта: чертах
читать: читать
член: членом
экспорт: экспорт
элемент: элемент
энциклопедия: энциклопедии
эсер: эсеров
этот: эта
ю: ю
юность: юности
язык: языках
