абовян: абовяна
автопортрет: автопортрет автопортреты
авторство: авторства
агаджанян: агаджанян агаджаняна агаджаняну
академия: академии академия
алфавит: алфавиту
арма: арм
армения: армении
армянский: армянская армянский армянского армянской
бакинский: бакинская
баку: баку
беларускать: беларуская
беспризорник: беспризорник
бесприютный: бесприютный
библиографический: библиографических
биография: биография
больший: большая
большинство: большинство
брать: брал
васил: васил
василь: василь
век: века
вернуться: вернулся
версия: версии версия
викидать: викиданных
викимедиа: викимедиа
википедия: википедии википедия
викисклад: викисклад викискладе
вклад: вклад
внешний: внешние
войти: войти
волшебный: волшебные
выдающийся: выдающиеся
выделяться: выделяются
г: г
галерея: галерее галерея
гевондяный: гевондян
глубокий: глубоким
год: годах году лет
город: города городе
гражданство: гражданство
григорян: григорян
губерния: губерния
дата: дата
действовать: действовать
декабрь: декабря
дело: деле
деятельность: деятельности деятельностью
дон: дону
дополнительный: дополнительные
доска: доска
доступный: доступен
др: др
драматург: драматург
другой: других
духовный: духовной
дядюшка: дядюшка
ереван: ереван еревана ереване
ереванский: ереванском
ещё: ещё
жан: жана
жанр: жанр
жена: жена
женщина: женщина
живописец: живописец
жить: жил
жозефа: жозефа
жюлиан: жюлиана
заглавный: заглавная
заниматься: заниматься
запись: запись
заполнить: заполнить
зарегистрировать: зарегистрированный
заслуга: заслуги
заслужить: заслуженные заслуженный
заявление: заявление
звание: звания
знак: знак
знамя: знамени
избранный: избранные
известный: известны
изменение: изменения
изображение: изображениями
империя: империя
имя: имя имён
инструмент: инструменты
искусство: искусства
использование: использования
использовать: использующие
история: истории история
источник: источник
июнь: июня
кавалер: кавалеры
карабахский: карабахская
картина: картин
картинный: картинная картинной
каталог: каталогах
категория: категории
код: код
кодекс: кодекс
колорит: колорита
композитор: композитор
констан: констана
конфиденциальность: конфиденциальности
короткий: короткий
красный: красного
кук: куки
литература: литература
лицензия: лицензии
лоран: лоран лорана
м: м
марсел: марселе
мастерская: мастерской
материал: материал
мать: матери
медиафайл: медиафайлы
меликсетович: меликсетович
мемориальный: мемориальная
место: место
мобильный: мобильная
мочь: могут
музей: музей
музыкальный: музыкального
мы: нами
навигация: навигации навигация
награда: награды
написать: написал написанные
народный: народные народный
национальный: национальная национальной
начальный: начальное
некоммерческий: некоммерческой
новый: новые
нська: нська
образование: образование
обсуждение: обсуждение
обучаться: обучавшиеся обучался
ожидать: ожидают
описание: описание
организация: организации
орден: орден ордена
особенно: особенно
ответственность: ответственности
отдельный: отдельных
отказ: отказ
отличаться: отличавшиеся
отредактировать: отредактирована
ошибка: ошибке
п: п
память: память
париж: париже
парный: парные
педагог: педагог
передача: передачей
переехать: переехал
перейти: перейти
персоналия: персоналии
персональный: персональные
печать: печати печать
поведение: поведения
подробный: подробнее
пожертвовать: пожертвовать
поиск: поиск поиску
поле: поля
политика: политика
получить: получил получить
портрет: портрет портретов портреты
портретист: портретист портретисты
последний: последний
постоянный: постоянная
править: править
правка: правки
превращаться: превращаются
представиться: представились
преподавательский: преподавательской
преподавать: преподавал
примечание: примечания
проверить: проверена
проверка: проверки
продолжить: продолжил
проект: проектах
произведение: произведений
просмотр: просмотры
пространство: пространства
профессиональный: профессиональное
психологизм: психологизмом
работа: работы
развитие: развития
разработчик: разработчики
реалистический: реалистические
реальный: реальном
ресурс: ресурсы
рисование: рисование
родина: родину
родитель: родителей
родиться: род родившиеся
рождение: рождении рождения
российский: российская
ростов: ростове
русский: русский русском
сведение: сведения
свежий: свежие
свободный: свободной
свой: своих
свойство: свойство
связанный: связанные
связаться: свяжитесь
сдержанность: сдержанностью
седрака: седрак
сестра: сестра
система: системе
скачать: скачать
скрытый: скрытые
служебный: служебные
случай: случаях
случайный: случайная
смерть: смерти
смотреть: см
событие: события
содержание: содержание
создать: создал созданных создать
сообщество: сообщество
сообщить: сообщить
сохранение: сохранением
справка: справка
среди: среди
сср: сср
ссср: ссср
ссылка: ссылка ссылки
стабильный: стабильная
статистика: статистика
статья: статьи статья
степан: степан
степанос: степанос
страница: страница странице страницу страницы
студия: студии
сюда: сюда
творчество: творчество
театральный: театрального
текст: текст
текущий: текущая текущие
тереть: тер
тип: типы
товарный: товарный
трудовой: трудового
указание: указанием
укра: укра
улица: улица
умерший: умершие
урок: уроки
условие: условий условия
участие: участие
училище: училище
учиться: учился
учёба: учёба
учётный: учётную
фамилия: фамилией
фонд: фонд
форум: форум
характер: характеров
хороший: лучших
храниться: хранится
хронография: хронография
художественный: художественной художественном
художник: художник художника художники
цитировать: цитировать
часть: часть
человек: людях
читать: читать
шаблон: шаблонов
школа: школах школе
шуша: шуша шуше шушу
экспорт: экспорт
элемент: элемент
эмин: эмин
энциклопедия: энциклопедии
этот: эта
язык: языках
