австро: австро
авторство: авторства
алфавит: алфавиту
амош: амоша
амоша: амош
англ: англ
анна: анны
анне: анне
берег: берег
библиографический: библиографических
биографический: биографический
биография: биография
быть: е
вд: вд
век: века
венг: венг
венгерский: венгерский
венгрия: венгрии венгрия
версия: версия
викидать: викиданных
викимедиа: викимедиа
википедия: википедии википедия
викисклад: викисклад викискладе
вклад: вклад
влияние: влиянием
внешний: внешние
воеводин: воеводине
возраст: возрасте
война: война войны
войти: войти
волшебный: волшебные
время: времена время
встречаться: встречался
второй: второй
выслать: выслан
выставить: выставлены
германия: германии германия
год: году лет
город: городе
гот: гота
гражданство: гражданство
дата: дата
действовать: действовать
декабрь: декабря
деятель: деятели
деятельность: деятельности
дополнительный: дополнительные
доступный: доступен
другой: других
дюла: дюла
еврейский: еврейского
ещё: ещё
жанр: жанр
жениться: женился
живопись: живопись
жить: жил
заглавный: заглавная
запись: запись
зарегистрировать: зарегистрированный
заявление: заявление
знак: знак
избегать: избегая
избранный: избранные
избрать: избран
изобразительный: изобразительного изобразительных
имре: имре
имя: имён
инструмент: инструменты
искусство: искусств искусства
использование: использования
использовать: использующие
история: история
источник: источник источниками
картина: картин картина картины
каталог: каталогах
категория: категории
код: код
кодекс: кодекс
конфиденциальность: конфиденциальности
концентрационный: концентрационный
концлагерь: концлагерь концлагерях
короткий: короткий
кук: куки
лагерь: лагерь
лето: летом
литература: литература
лицензия: лицензии
маргит: маргит
марк: марком
материал: материал
медиафайл: медиафайлы
медие: медье
место: место
мечтать: мечтающий
мировой: мировой
мобильный: мобильная
мочь: могут
музей: музей
мы: нами
навигация: навигации навигация
надькалло: надькалло
написать: написал
находиться: находилось
нацистский: нацистской
начало: начале
неизвестный: неизвестна
некоммерческий: некоммерческой
некоторый: некоторые
новый: нового новые
ноябрь: ноября
обращение: обращения
обсуждение: обсуждение
общество: общества
описание: описание
организация: организации
ордруф: ордруф
ответственность: ответственности
отдельный: отдельных
отказ: отказ
отправить: отправлен
отредактировать: отредактирована
ошибка: ошибке
париж: париж
перейти: перейти
персоналия: персоналии
персональный: персональные
печать: печати печать
поведение: поведения
погибнуть: погиб
погибший: погибшие
подпись: подписи
подробный: подробнее
пожертвовать: пожертвовать
поиск: поиск поиску
политика: политика
получить: получить
посетить: посетил
последний: последний
постоянный: постоянная
править: править
правка: правки
представиться: представились
призвать: призванные
примечание: примечания
проект: проектах
происхождение: происхождения
просмотр: просмотры
пространство: пространства
работать: работал
раввин: раввин
разработчик: разработчики
ресурс: ресурсы
родиться: род родившиеся
рождение: рождения
руднай: руднаи
русский: русский русской
сабольча: сабольч
сайт: сайте сайты
сатмара: сатмар
сведение: сведения
свежий: свежие
свободный: свободной
связанный: связанные
связаться: свяжитесь
сентендра: сентендре
сентябрь: сентября
середина: середины
серия: серию
система: системе
скачать: скачать
скрытый: скрытые
словарь: словари
служба: службу
служебный: служебные
случай: случаях
случайный: случайная
смерть: смерти
смотреть: см
событие: события
содержание: содержание
создать: создан создать
сообщество: сообщество
сообщить: сообщить
сохранение: сохранением
справка: справка
ссылка: ссылка ссылками ссылки
статистика: статистика
статья: статьи статья
страница: страница странице страницу страницы
супруг: супруга
сюда: сюда
творчество: творчество
текст: текст
текущий: текущие
тематический: тематические
товарный: товарный
точный: точная
транслейтаний: транслейтании
трудовой: трудовой трудовую
тюрингия: тюрингии тюрингия
тёмный: тёмные
ужас: ужасах
указание: указанием
умерший: умершие
условие: условий условия
участие: участие
учитель: учителем
учиться: учился
учёба: учёба
учётный: учётную
фонд: фонд
форум: форум
х: х
холокост: холокосте
художник: художник художники художников
художница: художнице
цитировать: цитировать
читать: читать
член: членом
шагал: шагалом
шагать: шагала
школа: школе
экспорт: экспорт
элемент: элемент элементы
энциклопедия: энциклопедии
эсп: эсп
этот: эта
язык: языках
