автор: автор
авторитетный: авторитетные
авторство: авторства
академический: академическое
академия: академии
александров: александров
алфавит: алфавиту
англия: англии
антонио: антонио
архивный: архивная
ассоциация: ассоциации
бельгия: бельгии
биография: биографии биография
вашингтон: вашингтон
ведущий: ведущих
век: века
версия: версия
вид: виде
викидать: викиданных
викимедиа: викимедиа
википедия: википедии википедия
вклад: вклад
войти: войти
всероссийский: всероссийских
всесоюзный: всесоюзных
вуз: вузов
выставка: выставке выставки выставок
г: г
германия: германии
год: года году лет
государственный: государственное государственный государственных
государство: государства
гражданство: гражданство
греция: греции греция
дата: дата
дать: данная
действовать: действовать
дело: делам
деловой: делового
департамент: департамента
деятель: деятели
дирекция: дирекции
добавить: добавить
дополнительный: дополнительные
доступный: доступен
др: др
другой: других
дружба: дружбы
душа: души
единый: единый
ещё: ещё
её: её
желательно: желательно
живописец: живописец
живописный: живописные
живопись: живописи
жить: живёт
заглавный: заглавная
зал: зале
занятие: занятий
запись: запись
зарегистрировать: зарегистрированный
заслужить: заслуженные заслуженный
заявление: заявление
звание: звания
зеркало: зеркало
знак: знак
избранный: избранные
изображение: изображений
изобразительный: изобразительного
иллюстрация: иллюстрации
имя: имён
инструмент: инструменты
исключить: исключите
искусство: искусств искусства
использование: использования
исправление: исправления
история: история
источник: источник источники источников
италия: италии
июль: июля
категория: категории
кипр: кипр
кира: кире
класс: классах классы
код: код
кодекс: кодекс
коллекция: коллекциях
конфиденциальность: конфиденциальности
копия: копия
короткий: короткий
корреспондент: корреспондент корреспонденты
кремль: кремле
кук: куки
культура: культуре
культурный: культурного культурных
лекция: лекциях
лигабуэ: лигабуэ
лицензия: лицензии
люксембург: люксембурге
март: марта
мастер: мастер
материал: материал
медаль: медаль
международный: международной международных
мексика: мексике
место: место
мид: мид
мир: мира
многий: многих
мобильный: мобильная
молодой: молодых
монументальный: монументальной
москва: москва москве
московский: московский московское московском
мочь: могут
музей: музеях
мы: нами
навигация: навигации навигация
награда: награды
найти: найти
написать: написанное
народ: народов
недостаток: недостатки недостатков
независимый: независимые
некоммерческий: некоммерческой
никитович: никитович
новый: новые
обсуждение: обсуждение
окончить: окончил
описание: описание
организация: организации
ответственность: ответственности
отделение: отделение
отдельный: отдельных
отказ: отказ
оформить: оформить
ошибка: ошибке
память: памяти
передвижной: передвижной
перейти: перейти
персоналия: персоналии
персональный: персональные
печать: печати печать
пленэр: пленэры
поведение: поведения
подробный: подробнее
подтверждать: подтверждающие
пожертвовать: пожертвовать
поиск: поиск поиску
политика: политика
получить: получить
посольство: посольства
поучаствовать: поучаствовали
править: править
правка: правки
правление: правления
право: правами
представительский: представительском
представить: представлены
представиться: представились
примечание: примечания
проблема: проблемы
проверяться: проверялась
программа: программ программа
проект: проектах
пройти: прошли
промышленный: промышленный
просмотр: просмотры
пространство: пространства
профессиональный: профессиональных
работа: работы
работать: работает
разработчик: разработчики
рах: рах
реестр: реестр
республиканский: республиканских
родиться: род родившиеся родился
рождение: рождения
роспись: росписи
российский: российского российской
россия: россии россия
руководитель: руководитель
русский: русский
рф: рф
сведение: сведения
свежий: свежие
свободный: свободной
связанный: связанные
связаться: свяжитесь
семинар: семинарах
сергей: сергей
система: системе
скачать: скачать
скрытый: скрытые
служебный: служебные
случай: случаях
случайный: случайная
смотреть: см
сноска: сносок
собрание: собраниях
событие: события
современник: современников
содержание: содержание
создать: создать
сообщество: сообщество
сообщить: сообщить
соответствующий: соответствующими
сотрудничество: сотрудничества
сохранение: сохранением
союз: союз союза
список: списка
справка: справка
ссср: ссср
ссылка: ссылки ссылок
стажировка: стажировка
статистика: статистика
статья: статьи статья
страна: стран странах страны
страница: страница странице страницы
строганов: строганова
студент: студенты
сша: сша
сюда: сюда
талант: талантов
текст: текст
текущий: текущие
тип: тип
товарный: товарный
триптих: триптиха
удалить: удалите
указание: указанием
улучшение: улучшения
университет: университет
условие: условий условия
устранить: устранены
участие: участие
участник: участник участниками
училище: училище
учётный: учётную
фамилия: фамилией
федерация: федерации
фестиваль: фестивалях
финляндия: финляндии
фонд: фонд
форум: форум
франция: франции
художественно: художественно
художественный: художественное художественный художественных
художество: художеств
художник: художник художники художников
частный: частных
человек: людях человек
читать: читать
член: член члены
шаблон: шаблон шаблонами
экспорт: экспорт
элемент: элемент
энциклопедия: энциклопедии
юнеско: юнеско
язык: языках
