авторство: авторства
академия: академии
активно: активно
алфавит: алфавиту
апрель: апреля
архивировать: архивировано
аспелина: аспелин аспелина
ассоциация: ассоциации
библиографический: библиографических
биография: биография
брёсарпа: брёсарпе
булла: буллу
быть: будучи
век: века
вернуться: вернувшись
версия: версия
вид: видом
викидать: викиданных
викимедиа: викимедиа
википедия: википедии википедия
викисклад: викисклад викискладе
вилла: вилле
вильгельм: вильгельм
виттенберг: виттенберга
вклад: вклад
внешний: внешние
войти: войти
вокруг: вокруг
вранер: вранера
врач: врача
вырасти: вырос
герт: герта
год: года году
гуннар: гуннар гуннара
густав: густав густава
дата: дата
дед: дедом
дедешё: дедешё
действовать: действовать
деятельность: деятельности
дополнительный: дополнительные
доступный: доступен
друг: друзей
другой: других
единственный: единственным
ещё: ещё
жанровый: жанровым
живой: живых
живописный: живописном
заглавный: заглавная
залив: залив
запись: запись
заполнить: заполнить
зарегистрировать: зарегистрированный
затем: затем
заявление: заявление
знак: знак
избранный: избранные
изображение: изображениями
иллюстрировать: иллюстрировал
импрессионист: импрессионистом
имя: имён
инструмент: инструменты
интерьер: интерьеры
искусство: искусств
использование: использования
использовать: использующие
история: история
источник: источник
июль: июля
йохан: йохан йохана
карл: карл
каталог: каталогах
категория: категории
код: код
кодекс: кодекс
коллега: коллег
коллектив: коллективом
конфиденциальность: конфиденциальности
копенгаген: копенгагене
королевский: королевской
короткий: короткий
который: который
крунуберг: крунуберг
кук: куки
лена: лене
лицензия: лицензии
луис: луис
лунд: лунд
лунда: лунде
лютереть: лютер
март: марта
материал: материал
медиафайл: медиафайлы
место: место
мобильный: мобильная
мочь: могут
музей: музее
мы: нами
навигация: навигации навигация
навсегда: навсегда
национальный: национальном
некоммерческий: некоммерческой
неопр: неопр
несколько: несколько
новый: новые
ноябрь: ноября
обращение: обращения
обсуждение: обсуждение
описание: описание
организация: организации
остаться: оставшимся
ответственность: ответственности
отдельный: отдельных
отец: отец отцом
отказ: отказ
отредактировать: отредактирована
ошибка: ошибке
папский: папскую
париж: париже
пастельщик: пастельщик
пейзаж: пейзажи
первый: первым
перейти: перейти
персея: персея
персоналия: персоналии
персональный: персональные
печать: печати печать
писать: писавший
площадь: площади
поведение: поведения
подробный: подробнее
пожертвовать: пожертвовать
поздний: позже
поиск: поиск поиску
политика: политика
получить: получить
портрет: портреты
поселиться: поселился
последний: последний
постоянный: постоянная
править: править
правка: правки
представить: представлен
представиться: представились
примечание: примечания
провинциальный: провинциального
проект: проектах
просмотр: просмотры
пространство: пространства
прочее: прочего
работать: работал
разработчик: разработчики
рассказ: рассказов
расширение: расширение
ребёнок: дети ребёнком
регин: регины
ресурс: ресурсы
родина: родину
родиться: род родившиеся
рождение: рождения
русский: русский
сайт: сайты
сведение: сведения
свежий: свежие
свободный: свободной свободных
свойство: свойство
связанный: связанные
связаться: свяжитесь
сжигать: сжигает
система: системе
сканий: скания
скачать: скачать
скрытый: скрытые
служебный: служебные
случай: случаях
случайный: случайная
смерть: смерти
смотреть: см
собрать: собрал
событие: события
содержание: содержание
создать: создать
сольбаккен: сольбаккен
сообщество: сообщество
сообщить: сообщить
сохранение: сохранением
справка: справка
среди: среди
ссылка: ссылка ссылки
статистика: статистика
стать: стал
статья: статьи статья
стиль: стиле
стокгольм: стокгольме
страна: страна
страница: страница странице страницу страницы
студия: студией
сюда: сюда
также: также
текст: текст
текущий: текущие
тематический: тематические
товарный: товарный
указание: указанием
указать: указан
умерший: умершие
условие: условий условия
участие: участие
учиться: учился
учёба: учёбы
учётный: учётную
философ: философа
фонд: фонд
форум: форум
ханё: ханё
хеденстьерный: хеденстьерны
хенрик: хенрика
художник: художник художника художники художников художником
цитировать: цитировать
чивика: чивике
читать: читать
швед: швед
шведский: шведский
швеция: швеции швеция
эдвард: эдварда
экспорт: экспорт
элемент: элемент
энциклопедия: энциклопедии
эпоха: эпохи
эстерлен: эстерлене
этот: эта
являться: являлся
язык: язык языках
