автор: автор
авторство: авторства
академия: академии
активно: активно
александр: александр
алексеев: алексеев
алексей: алексею
алфавит: алфавиту
биография: биографии биография
благодарность: благодарность
благодарственный: благодарственное
быть: е
век: века веков
версия: версия
вести: вел
вестибюль: вестибюля
викидать: викиданных
викимедиа: викимедиа
википедия: википедии википедия
вклад: вклад
войти: войти
время: время
всехсвятский: всехсвятскому
втоо: втоо
выставка: выставках выставок
г: г
геннадиевич: геннадьевич
год: года годах году годы
город: города
государственный: государственных
дата: дата
действовать: действовать
дело: дело
деятель: деятели
деятельность: деятельность
дипломант: дипломант
добавить: добавить
дом: доме
дополнительный: дополнительные
доступный: доступен
другой: других
ещё: ещё
жанр: жанр
живопись: живописи
заглавный: заглавная
занятие: занятий
запись: запись
зарегистрировать: зарегистрированный
заслужить: заслуженные заслуженный
затем: затем
заявление: заявление
звание: звания
знак: знак
избранный: избранные
изображение: изображений
изобразительный: изобразительного
имя: имени имён
инициатор: инициаторов
инструмент: инструменты
искусство: искусства искусству
использование: использования
история: история
источник: источник
калинин: калинина
категория: категории
клуб: клубе
код: код
кодекс: кодекс
коллекция: коллекциях
комиссия: комиссии
конец: конца
конфиденциальность: конфиденциальности
коперник: коперник
короткий: короткий
который: которого
кремль: кремля
кружок: кружок
кук: куки
ленин: ленина
летие: летия
лицензия: лицензии
м: м
март: марта
мастер: мастер мастеру
материал: материал
медаль: медаль медалью
место: место
миниатюрный: миниатюрной
многий: многих
мобильный: мобильная
монументальный: монументальное
москва: москве москвы
московский: московское
мочь: могут
музей: музее музеев
муниципалитет: муниципалитета
мы: нами
навигация: навигации навигация
награда: награды
наградить: награждённые
народный: народному народные народный
настоящий: настоящее
находиться: находятся
некоммерческий: некоммерческой
неопр: неопр
николай: николай
новый: новые
областной: областное
область: область
обращение: обращения
обсуждение: обсуждение
один: одного
окончание: окончания
окончить: окончил
октябрь: октября
описание: описание
организация: организации
осваивать: осваивал
ответственность: ответственности
отделение: отделение
отдельный: отдельных
отказ: отказ
отредактировать: отредактирована
оформление: оформления
ошибка: ошибке
память: память
панно: панно
перейти: перейти
перерыв: перерывами
персоналия: персоналии
персональный: персональные
печать: печати печать
пионер: пионеров
письмо: письмо
пластина: пластин
поведение: поведения
подробный: подробнее
пожертвовать: пожертвовать
поиск: поиск поиску
политика: политика
получить: получить
посвятить: посвящённого
последний: последний
постоянный: постоянная
править: править
правка: правки
правление: правления
председатель: председателем
представиться: представились
преподавать: преподавал
проект: проектах
произведение: произведения
промышленный: промышленное
просмотр: просмотры
пространство: пространства
работать: работал
различный: различного
разработчик: разработчики
район: район
родиться: род родившиеся родился
рождение: рождения
рольм: рольма
российский: российский российской
россия: россии россия
ростов: ростов ростове
ростовский: ростовская ростовский ростовских ростовского ростовской
рсфср: рсфср
рубеж: рубежа рубежом
русский: русский
сведение: сведения
свежий: свежие
свободный: свободной
связанный: связанные
связаться: свяжитесь
середина: середине
система: системе
скачать: скачать
скрытый: скрытые
служебный: служебные
случай: случаях
случайный: случайная
смотреть: см
собрание: собраниях
событие: события
советский: советский
современник: современников
содержание: содержание
создание: создания
создать: создал создать
сообщество: сообщество
сообщить: сообщить
состоять: состоящее
сохранение: сохранением
союз: союз союза
справка: справка
ссср: ссср
ссылка: ссылка ссылки
статистика: статистика
стать: стал
статья: статьи статья
страна: страна
страница: страница странице страницу страницы
схр: схр
сюда: сюда
также: также
творчески: творчески
творческий: творческая
текст: текст
текущий: текущие
тип: тип
товарищество: товарищества
товарный: товарный
указание: указанием
уровень: уровня
условие: условий условия
участвовать: участвовал
участие: участие
участник: участником
училище: училище
учёба: учёба
учётный: учётную
фабрика: фабрике фабрики
фамилия: фамилией
федерация: федерации
финифть: финифти финифть
финифтянщик: финифтянщику
фонд: фонд
форум: форум
х: х
художественно: художественно
художественный: художественной художественных
художество: художеств
художник: художник художники художников
цитировать: цитировать
частный: частных
человек: людях человек
читать: читать
член: член членом члены
школа: школе
экспонироваться: экспонируется
экспорт: экспорт
элемент: элемент
эмаль: эмали
энциклопедия: энциклопедии
этот: эта
ювелирный: ювелирное
являться: является
язык: языках
ярославль: ярославля
ярославский: ярославская ярославское
