абдрашитов: абдрашитовым
абдуллович: абдуллович
абдулхаевич: абдулхаевич
август: августа
автор: автором
авторский: авторский
авторство: авторства
агафон: агафонов
агафонов: агафонова
административный: административное административных
академик: академика
академия: академии
академиясена: академиясене
активно: активно
акцент: акцентом
аллегорический: аллегорический
аллея: аллее аллея
алсу: алсу
алфавит: алфавиту
альбом: альбом
альметьевец: альметьевца
альметьевнефть: альметьевнефть
альметьевск: альметьевск альметьевска альметьевске
альметьевский: альметьевская альметьевский альметьевского альметьевской
алюминий: алюминием алюминию
англ: англ
ановый: анов
апрель: апреля
архивировать: архивировано
архитектурный: архитектурно архитектурных
атрибутика: атрибутике
афиша: афиш
ахмадуллин: ахмадуллина
б: б
база: базы
батыр: батыр батыра
баш: баш
башкортостан: башкортостана
бетон: бетон бетоном
бизнес: бизнес
биографический: биографический
биография: биография
блокнот: блокнот
богатый: богатой
большой: большой
бронза: бронзой бронзу
бугульма: бугульма бугульме бугульму бугульмы
бугульминский: бугульминского бугульминском
булгар: булгар
булгарий: булгария
булгарский: булгарского
быть: будучи е
бюст: бюст бюстов бюсты
важный: важное
ваза: вазы
валеев: валеева
валиуллин: валиуллина
вандал: вандал вандалов вандалы
вверх: вверх
ввиду: ввиду
ведение: ведении
ведущий: ведущих
век: века
великий: великий великой
версия: версия
вертикальный: вертикального
верховой: верховой
вечный: вечный
вид: вид виде видом
викидать: викиданных
викимедиа: викимедиа
википедия: википедии википедия
виртуальный: виртуальный
вклад: вклад
владимир: владимир владимире
владимирский: владимирский
внешний: внешние внешний
возбудить: возбуждено
возле: возле
воин: воина
воительница: воительницы
вой: вой
война: войн
войти: войти
волшебный: волшебные
воплощение: воплощение воплощением
вопрос: вопросов
восточный: восточного
время: времен время
вскоре: вскоре
встречаться: встречается
всё: всё
вход: входа
въезд: въезде
выглядеть: выглядит
выгодный: выгодного
вызывающий: вызывающего
выйти: выйдя
выколотка: выколотки
выпускник: выпускники
выразительность: выразительности
выразить: выражена выражено
выручить: выручил
высокий: высоком
выставка: выставках выставке
выставляться: выставлялся
выступить: выступив выступил
вытянутый: вытянута
выше: выше
г: г
габделха: габделх
габдулла: габдулла
габдулхаевич: габдулхаевич
газета: газета
галерея: галерее
галлямов: галлямова
гафиатуллин: гафиатуллина
герой: героев героя
гиматдинов: гиматдинова
гимназия: гимназии
гимнастка: гимнастка
гипс: гипс гипса гипсом
гипсовый: гипсовая гипсовых
гл: гл
глина: глины
год: гг год года годах году лет
головной: головной
голубеть: голубей
гомерла: гомерле
горельеф: горельефа
гористый: гористого
город: города городов
городской: городских городском
гостеприимство: гостеприимство
государственный: государственный
готовый: готовые
градация: градации
гражданский: гражданской
гражданство: гражданство
гранитный: гранитном
графика: графика графики графикой
графов: графова
грубоватый: грубоватой
грудь: груди
группа: группы
губкин: губкина
гузель: гузель
гульнур: гульнур
гуманитарный: гуманитарные
далее: д
дальнейший: дальнейшем дальнейшую
дата: дата даты
два: двух
двенадцать: двенадцати
движение: движением
девон: девона
девушка: девушки
действовать: действовать
декоративный: декоративно декоративное декоративной декоративные декоративных
декорационный: декорационное
декорация: декораций
дело: дело
держать: держит
десять: десять
деталь: детали деталях
детский: детской
деятель: деятелей деятели деятелям
деятельность: деятельности
джалиль: джалиль
диск: диск
длинный: длинного
добавить: добавить
долгий: долгой
домик: домик
доп: доп
дополнительный: дополнительные
доступный: доступен
дочь: дочерей
драматический: драматический драматического
древний: древнейших
другой: другим других
дусаева: дусаева
единственный: единственным
единый: единое
елена: елена
естественный: естественного
ефрем: ефремов
ещё: ещё
её: её
жанр: жанр
жанровый: жанровых
жена: жена
женщина: женщина женщины
жест: жестом
живописец: живописец
живопись: живопись живописью
жизнь: жизни жизнь
житель: жителя
жить: жил
журналист: журналиста
з: з
забыть: забыть
заглавный: заглавная
задержать: задержали задержан
задний: задняя
задумка: задумке
заказ: заказов
заливать: заливал
занимать: занимали
заниматься: занимался
занять: занял
заняться: занявшихся
записка: записки
запись: запись
заработать: заработал
зарегистрировать: зарегистрированный
заслужить: заслуженный
затем: затем
заявление: заявление
звезда: звездами
здание: здание зданием зданий
земля: земли земля
знак: знак
знаменитый: знаменитая
знамя: знамя
значение: значением
зональный: зональных
зухра: зухра
ибн: ибн
ибрагимов: ибрагимова
иванович: иванович
ивановский: ивановская
избранный: избранные
известный: известным
издательство: издательство
изначально: изначально
изначальный: изначальной
изображение: изображения
изобразительный: изобразительного изобразительное изобразительные
иметь: имели
имя: именем имени имён
институт: институт институты
инструмент: инструменты
интерьер: интерьеры
информ: информ
искать: ищет
искусство: искусства искусстве искусство искусством
исполнять: исполнял
использование: использования
использовать: использующие
испытывать: испытывал
исследовательский: исследовательских
история: истории история
источник: источник
июль: июля
июнь: июня
й: й
ймановый: йманова
йорт: йорт
казан: казан
казанский: казанский казанского казанское
казань: казани казань
казнь: казнью
калфак: калфак
кальметов: кальметова
камзол: камзол
каркас: каркас каркасу
картинный: картинной
категория: категории категория
катерина: катерина
качественный: качественный
качество: качестве качество
киндери: киндери
кирпич: кирпича
кладбище: кладбище
книжный: книжное
кова: ковой
код: код
кодекс: кодекс
коллекция: коллекциях
колый: колыю
комбинат: комбината
коммерция: коммерции
коммунистический: коммунистической
комплекс: комплекс комплекса
композиция: композиций композициях
конфиденциальность: конфиденциальности
кормилица: кормилицы
короткий: короткий
корреспондент: корреспондента
костюм: костюме костюмов
который: которая которые который
краеведческий: краеведческого
кража: краже
край: края
красота: красоту
крепиться: крепились
крестить: крещённые
критик: критикам
критика: критики
крупный: крупным крупных
кудряшева: кудряшева
кук: куки
культура: культура культуры
курсовой: курсового
л: л
лагер: лагере
ладонь: ладони
лаконичность: лаконичность
левый: левая
лениногорск: лениногорска
лепить: лепил
лестничный: лестничными
лиева: лиева
лис: лис
лист: листов листы
литература: литература литературы
лицей: лицея
лицензия: лицензии
личный: личная
лишь: лишь
локоть: локте
луч: лучами
любовь: любви
лётчик: лётчика
м: м
мавль: мавле
мазгар: мазгаров
май: мая
майдан: майдан
максимально: максимально
маленький: меньше
малый: малой
манакова: манакова
март: марта
марш: маршами
мастер: мастером
мастерская: мастерской
матвиевский: матвиевский
материал: материал
материальный: материальной
мать: матери мать
машенцев: машенцева
медаль: медали
медальер: медальеры
медноногов: медноногова
медный: медного медные медных
медь: меди медью
место: месте место
месяц: месяца
металл: металл металла
металлический: металлическому
металлолом: металлолом
мир: мира
многие: многие
мобильный: мобильная
моделировка: моделировкой
модель: моделей модель
молодой: молодой
монументалист: монументалист монументалисты
монументальность: монументальностью
монументальный: монументальная монументально монументальной
москва: москва
мочь: могут
мрамор: мрамором
мужчина: мужчина
музей: музей музея
музыкальный: музыкальная музыкальной
муса: муса
мы: нами
н: н
навигация: навигации навигация
нагимов: нагимова
нагрудный: нагрудное
наиболее: наиболее
найти: нашло нашёл
направленность: направленности
народный: народного
настенный: настенные
наука: наук наука науки
научий: науч
научно: научно
находиться: находится находятся
национальность: национальности
национальный: национально национального национальной национальном национальным
начало: начала начало
нгда: нгду
невозможно: невозможно
некоммерческий: некоммерческой
некрополь: некрополь
неопр: неопр
неотъемлемый: неотъемлемой
неофициальный: неофициальных
непропорциональный: непропорциональной
несколько: несколькими несколько
нефтегазодобывающий: нефтегазодобывающее
нефтяник: нефтяников
нефтяной: нефтяного нефтяных
никак: никак
никитин: никитина
нн: нн
новаторский: новаторским
новый: нов новая новые новых
ногмана: ногману
нужный: нужным
ны: ны
ныне: ныне
оао: оао
оба: обе
обладать: обладает
область: области область
облик: облике
облицовочный: облицовочного
обобщение: обобщением
обобщённый: обобщенный
образ: образ образов
образность: образности
обращение: обращения
обсуждение: обсуждение
общественный: общественных
общий: общего
обычный: обычной
огонь: огнём огонь
ограничиваться: ограничивалось
один: одним
однако: однако
оздоровительный: оздоровительном
окончить: окончив
олицетворять: олицетворяющей
описание: описание
опора: опора
определённый: определённой определённую
организация: организации
оригинальный: оригинального оригинальной
орнаментальный: орнаментально
орнаментировать: орнаментированный
основоположник: основоположником
остаться: остались
ответственность: ответственности
отделение: отделение
отдельно: отдельно
отдельный: отдельные отдельных
отечественный: отечественной
отказ: отказ
отливка: отливка отливке
отличаться: отличаются отличающегося
отмечать: отмечал
отношение: отношении
отредактировать: отредактирована
отсутствие: отсутствием отсутствия
отходить: отходящими
оформление: оформлением
охраняться: охраняется
очерк: очерк
ошибка: ошибке
п: п
памятник: памятник памятника памятников
памятование: памятование
парка: парке парки
певцов: певцова
педагог: педагоги
педагогический: педагогическую
пенсия: пенсию
первый: первое первых
переехать: переехал
перейти: перейти перешёл
переместить: перемещённых
персоналия: персоналии
персональный: персональные
песня: песня
печать: печати печать
писать: писал
плакат: плакаты
плакатист: плакатист плакатисты
плакетка: плакеток
платье: платья
площадка: площадка
площадь: площади
победитель: победитель
поведение: поведения
поверхность: поверхности
подготовительный: подготовительных
поднять: поднятая
подробный: подробнее
подсветка: подсветкой
подчеркнуть: подчеркнута
пожертвовать: пожертвовать
поздний: позднее
поиск: поиск поисков поиску
покрывало: покрывал
политика: политика
полицейский: полицейские полицейскими
полиция: полиция
получить: получившей получить
помещение: помещений
помимо: помимо
помощь: помощью
понять: понять
попов: попова
портрет: портретах портретов
порядок: порядка
посвятить: посвящённые посвящённых
последний: последний последняя
посредством: посредством
постамент: постамент постаменте
постоянный: постоянная
поступить: поступил
похоронить: похороненные
похоронный: похоронен
поэт: поэта
править: править
правка: правки
правый: правая
практически: практически
председатель: председатель
представиться: представились
представлять: представляющим
преподаватель: преподаватель
преподавать: преподавал
приезд: приезде
прикладной: прикладное прикладным
прилегать: прилегающих
примета: приметой
примечание: примечания
причина: причине
приём: приёма
провести: провели
продолжательница: продолжательницы
проект: проектах
произведение: произведением произведения произведениях
производственный: производственных
промышленный: промышленная
проработка: проработкой
прорезать: прорезана
просмотр: просмотры
пространственный: пространственного пространственной пространственный
пространство: пространства
профессиональный: профессиональный профессиональных
проявление: проявление
птица: птица
пункт: пункт
пьедестал: пьедестале
пятиконечный: пятиконечными
пётр: петр
р: р
работа: работ работой работу работы
работать: работал
работник: работник
рабочий: рабочих
развитие: развитии развития
разлетаться: разлетающимися
различный: различных
размещаться: размещалась
разобрать: разобравший разобравших разобрали разобрана
разработчик: разработчики
район: район района районов
районный: районных
ракурс: ракурса
распределение: распределению
рафаэль: рафаэль
реалистический: реалистической
регион: региона
региональный: региональной
ред: ред
реж: реж
резец: резца
рельеф: рельефа
республика: республика республики
республиканский: республиканских республиканской
республикас: республикасы
реставрационный: реставрационные
решение: решения
ри: ри
род: рода
родина: родине родины
родиться: род родившиеся родился
родниковый: родников
родный: родная
рождение: рождения
роль: роль
романтический: романтической
российский: российская российский российской
россия: россии россия
рсфср: рсфср
рубль: рублей
рудаков: рудакова
рука: рук рука
руководитель: руководителем
руководство: руководством
русский: русский
русый: рус
рухият: рухият
рычкова: рычкова
рычковы: рычков
ряд: ряд ряде
сабантуй: сабантуя
садовин: садовин
самодеятельный: самодеятельных
самый: самая
свариваться: сваривался
сведение: сведения
свежий: свежие
свет: света
светящийся: светящийся
свободный: свободной
своеобразие: своеобразием
свой: своим своё
связанный: связанные
связать: связавший связан
связаться: свяжитесь
связывать: связывали
сдавать: сдавал
сдвиг: сдвиг
себя: собой
село: селе
семиметровый: семиметровая
семья: семье
сентюков: сентюкова
сентябрь: сентября
серия: серия
сивол: сиволом
силуэт: силуэта силуэтами
символ: символа символов
символизировать: символизирует
символикий: символико
система: системе
скачать: скачать
склонный: склонным
склёпывать: склёпывали
скончаться: скончался
скрытый: скрытая
скульптор: скульптор скульпторы
скульптура: скульптура скульптуре скульптурой скульптуру скульптуры
скульптурный: скульптурной скульптурный скульптурных
сложить: сложенная
слой: слоем
служебный: служебные
случай: случаях
случайный: случайная
смерть: смерти
смотреть: см
смотреться: смотрелась
смотровой: смотровым
сначала: сначала
снимать: снимал
событие: события
советский: советский советского советской
совместно: совместно
современность: современности
согласно: согласно
согнутый: согнута
содержание: содержание
соединять: соединял
создавать: создавал создающего
создание: создания
создать: создавшим создал создать
сокровище: сокровища
солнце: солнца
сообщество: сообщество
сообщить: сообщить
сооружение: сооружений
соответствующий: соответствующих
сосредоточиться: сосредоточился
сохранение: сохранением
союз: союз союза
союзнефтеавтоматика: союзнефтеавтоматика
спаивать: спаивали
спасский: спасское
спектакль: спектаклю
спортивный: спортивного
справка: справка
справочник: справочник
спросить: спросили
среда: среды
ссср: ссср
ссылка: ссылка ссылки
стадион: стадионе
стан: стан
статистика: статистика
статуя: статуй статуя
стать: став ставшая стал
статья: статье статьи статья
стилизовать: стилизованы
стилобат: стилобате
стиль: стиль
стоить: стоит
сторона: сторону
страница: страница странице страницу страницы
стремиться: стремился
строго: строго
сулейманов: сулейманова
султанов: султанова
схематичный: схематичной
сценограф: сценограф сценографы
сыграть: сыграл
сын: сыновей
сыртланов: сыртлановой
сюда: сюда
так: т
также: также
такой: такие
тамгала: тамгалы
тарелка: тарелки
тат: тат
татарин: татар татарин
татария: татарии татария
татарский: татарская татарский татарского татарское татарской
татарстан: татарстан татарстана татарстаном
татарстанский: татарстанских
татнефть: татнефть
творческий: творческим творческих творческой
творчество: творчества творчестве
театр: театр театра
театрально: театрально
текст: текст
текущий: текущие
тема: тему темы
тематика: тематике
тенденция: тенденции
тень: тени
терраса: террасами
территория: территорий
техника: технике
течение: течение
товарный: товарный
тонирование: тонированием
тонировать: тонированный
торс: торса
тот: та
трактовка: трактовкой
труд: труда
трудиться: трудился
трудно: трудно
трудность: трудности
тукай: тукай тукаю
тысяча: тысяч тысячи
убор: убор
увлекаться: увлекался
уголовный: уголовное
уехать: уехал
указание: указанием
украсить: украсили
украсть: укравшего
украшение: украшение
улы: улы
умерший: умершие
университет: университет университета
управление: управление
упростить: упростить
уровень: уровне уровней
урсалабаш: урсалабаш
урсалинский: урсалинской
условие: условий условия
усманович: усмановна
установить: установлена
установленный: установленных
устроенный: устроенной
утомительный: утомительной
утратить: утрачены
участвовать: участвовал
участие: участие
учебный: учебно
училище: училища училище
учёба: учёба
учёный: ученые учёных
учёт: учётом
учётный: учётную
ф: ф
факельщик: факельщик
фамилия: фамилией
фасад: фасады
февраль: февраля
федеральный: федеральный
федерация: федерация
феникс: феникс
фигура: фигура
физкультура: физкультуры
филиал: филиале
фойе: фойе
фонд: фонд фонда
фонтан: фонтаном
форма: форм формы
форум: форум
фёдоров: фёдорова
х: х
халиуллин: халиуллина
халыко: халык
характеризоваться: характеризуется
характерный: характерных
хисамов: хисамова
хм: хм
холл: холл
хранительница: хранительницы
художественный: художественного художественное художественной
художник: художник художники художников художником
цветной: цветного
целое: целое
центр: центрах
цех: цеху
цитировать: цитировать
частность: частности
частный: частных
часто: часто
часть: части часть частью
чеканка: чеканки
человек: людях человеком
червонный: червонная
чистота: чистоту
читать: читать
чкалов: чкалова
член: члена
чылбыр: чылбыры
чёткий: чёткой
чёткость: четкость
швыткина: швыткин
широкий: широкая
широта: ш
школа: школа школе школы
э: э
экспорт: экспорт
элемент: элемент
энциклопедия: энциклопедии энциклопедия
энциклопедияло: энциклопедияле
энциклопедияс: энциклопедиясе
эскиз: эскизов
эскизный: эскизных
эстетика: эстетики
этот: эта этих
ю: ю
юбилейный: юбилейные
юго: юго
юность: юность
юсуп: юсупов
являться: является
язык: язык языка языках
як: яка
якуб: якубу
яркий: яркое
ячейка: ячейки
