абрахам: абрахама
авторство: авторства
ад: аду
академик: академик
академический: академический академического академическом
академия: академии академия
актёр: актеров
алфавит: алфавиту
анатолиевич: анатольевич
анатолий: анатолия
анкара: анкара
апрель: апреля
арефьев: арефьев арефьева
армия: армии
архивировать: архивировано
асафьева: асафьева
б: б
бал: бал
балет: балета
бахрушин: бахрушина
бахчисарайский: бахчисарайский
биза: бизе
биография: биографии биография
бишкек: бишкеке
болеро: болеро
больший: большие
большой: большой
борис: борис
василиевич: васильевича
вдова: вдова
век: века
верди: верди
версия: версия
весёлый: весёлая
викидать: викиданных
викимедиа: викимедиа
википедия: википедии википедия
вишнёвый: вишневый
вклад: вклад
вл: вл
владимир: владимир владимира
война: война
войти: войти
воткинск: воткинске
выпускник: выпускники
выставка: выставка
г: г
главный: главный
глинка: глинки
год: года году лет
годунов: годунов
город: города
горячий: горячее
государственный: государственные государственный государственными
гражданство: гражданство
гцтм: гцтм
далее: д
данченко: данченко
дата: дата
дать: данная
действительный: действительные
действовать: действовать
деятель: деятелей деятели
деятельность: деятельности деятельность
дж: дж
дизайнер: дизайнер
днепропетровский: днепропетровском
дополнительный: дополнительные
доступный: доступен
другой: других
дунаевский: дунаевского
екатеринбургский: екатеринбургском
ещё: ещё
жар: жар
женщина: женщины
жить: живёт
заглавный: заглавная
занятие: занятий
запись: запись
зарегистрировать: зарегистрированный
заслуга: заслуги
заслужить: заслуженные заслуженный
заявление: заявление
звание: звания
знак: знак
золотой: золотая
иванов: иванов
избранный: избранные
изображение: изображений
изобразительный: изобразительного
имя: имени имён
институт: институт
инструмент: инструменты
исаков: исакова
искусство: искусства искусству
использование: использования
история: история
источник: источник
июль: июля
июнь: июня
кавалер: кавалеры
кальмана: кальмана
кармена: кармен
категория: категории
киевский: киевском
кинодекорационный: кинодекорационного
киргизский: киргизская киргизской
клин: клину
код: код
кодекс: кодекс
конфиденциальность: конфиденциальности
короткий: короткий
корсаков: корсакова
красноярский: красноярском
кук: куки
культура: культуры
курилко: курилко
курс: курсом
л: л
лауреат: лауреаты
лебединый: лебединое
легар: легара
литература: литературе
лицензия: лицензии
м: м
май: мая
майский: майская
мамт: мамт
марш: марш
маска: маска
материал: материал
мауголь: маугли
маяковский: маяковского
мгха: мгхи
медаль: медаль
место: место
миллер: миллера
мир: мир
многолетний: многолетнюю
мобильный: мобильная
москва: москве москвы
московский: московская московский московского
моссовет: моссовета
моцарт: моцарта
мочь: могут
музей: музея музеях
музыкальный: музыкального музыкальной музыкальном
мусоргский: мусоргского
мушкетёр: мушкетера
мхат: мхат
мы: нами
н: н
навигация: навигации навигация
награда: наградами награды
награждение: награждении
народный: народного народные народный
наставшевс: наставшевс
находиться: находятся
некоммерческий: некоммерческой
немирович: немировича
неопр: неопр
новость: новость
новый: новые
ночь: ночь
нська: нська
область: области
обращение: обращения
обсуждение: обсуждение
общественный: общественные
озеро: озеро
окончить: окончил
опасный: опасный
опера: оперы
оперетта: оперетта оперетты
описание: описание
организация: организации
орден: орден ордена
орфей: орфей
основной: основные
островский: островского
ответственность: ответственности
отделение: отделение
отдельный: отдельных
отечественный: отечественной
отказ: отказ
открываться: открывается
оффенбах: оффенбаха
ошибка: ошибке
п: п
перейти: перейти
персоналия: персоналии
персональный: персональные
печать: печати печать
плодотворный: плодотворную
поведение: поведения
поворот: поворот
подробный: подробнее
пожарский: пожарской
пожертвовать: пожертвовать
поиск: поиск поиску
политика: политика
получить: получили получить
постановщик: постановщиков
поступать: поступают
почёт: почёта
править: править
правка: правки
право: правами
представиться: представились
президент: президента
премия: премии премию премия
примечание: примечания
пристлить: пристли
проверяться: проверялась
проект: проектах проекты
произведение: произведения
прокофьев: прокофьева
просмотр: просмотры
пространство: пространства
птица: птица
работа: работы
работать: работает
равель: равеля
развитие: развитие
разработчик: разработчики
рах: рах
риголетто: риголетто
римский: римского
родиться: род родившиеся родился
рождение: рождения
российский: российская российской
россинь: россини
россия: россии россия
руководить: руководит
русский: русский
русый: рус
рындин: рындина
рюмин: рюмина
савойя: савойе
сад: сад
сведение: сведения
свежий: свежие
свободный: свободной
связанный: связанные
связаться: свяжитесь
севастопольский: севастопольский
севильский: севильский
сентябрь: сентября
сердце: сердце
серебряный: серебряная
сильва: сильва
система: системе
скачать: скачать
скиф: скифы
скрытый: скрытые
служебный: служебные
случай: случаях
случайный: случайная
смотреть: см
собрание: собраниях
событие: события
современник: современник современников
содержание: содержание
содружество: содружества
создать: создать
сообщество: сообщество
сообщить: сообщить
соответствующий: соответствующими
сохранение: сохранением
союз: союза
справка: справка
сср: сср
ссср: ссср
ссылка: ссылки
станиславский: станиславского
статистика: статистика
статья: статьи статья
сташинский: сташинского
столица: столице
стравинский: стравинского
страница: страница странице страницы
студия: студии
суриков: сурикова
сценография: сценографии сценографию
сын: сын
сюда: сюда
таганка: таганки
тасс: тасс
театр: театра театре
театрально: театрально
театральный: театральную театральные театральный театральных
текст: текст
текущий: текущие
тип: тип
товарный: товарный
толстой: толстому
травиата: травиата
турандот: турандот
турция: турция
указ: указ
указание: указанием
укра: укра
украинский: украинской
условие: условий условия
участие: участие
участник: участниками
учиться: учился
учёба: учёба
учётный: учётную
ф: ф
фамилия: фамилией
февраль: февраля
федерация: федерации
фонд: фонд
фонтан: фонтан
форум: форум
фрунзе: фрунзе
хороший: лучшую
хрустальный: хрустальная
художественный: художественный
художество: художеств
художник: художник художника художники художников
цена: цена
центральный: центральном
цирюльник: цирюльник
чайковский: чайковского
человек: людях человек
чехов: чехова
читать: читать
член: член члены
школа: школе
шувалов: шувалов
щелкунчик: щелкунчик
экспорт: экспорт
элемент: элемент
энциклопедия: энциклопедии
эрнаня: эрнани
юбилей: юбилею
язык: языках
