абад: абаде
автор: автор
авторство: авторства
аз: аза
айти: айти
айтиева: айтиева
айтиевич: айтиевич
айтий: айтиев
академический: академическое
академия: академии
ала: ала
алтын: алтын
алфавит: алфавиту
андижан: андижана
арчинский: арчинском
ах: ах
б: б
батальон: батальона
биография: биография
битва: битве
бишкек: бишкек бишкеке
боевой: боевые
больший: большая
большой: большой
бригада: бригады
бсэ: бсэ
век: века
великий: великой
верник: верника
версия: версия
верховный: верховного
викидать: викиданных
викимедиа: викимедиа
википедия: википедии википедия
вклад: вклад
вкп: вкп
владимир: владимира
власов: власова
внешний: внешние
воевать: воевал
война: войне войны
войти: войти
вооружённый: вооружённых
восстание: восстания
выдающийся: выдающиеся
выпускник: выпускники
г: г
галерея: галерея
гап: гапа
гапара: гапар
гвардия: гвардии
генеалогия: генеалогия
генерал: генерал
германия: германией
герой: герои герой
го: го
год: гг года годах году лет
государственный: государственная государственное государственной
графика: графики
графический: графических
губернаторство: губернаторство
дата: дата
двадцать: двадцать
двор: двор
девушка: девушка
действовать: действовать
декабрь: декабря
дело: деле
день: дня
депутат: депутат депутаты
деятель: деятели деятель
деятельность: деятельности
джалал: джалал
доблесть: доблесть
должность: должности
дополнительный: дополнительные
доступный: доступен
др: др
драматический: драматического
другой: других
ева: ев
евич: евич
ещё: ещё
жанр: жанр
жанровый: жанровых
живописец: живописец
живопись: живописи живопись
заглавный: заглавная
заместитель: заместитель заместителя
западный: западном
запись: запись
заполнить: заполнить
зарегистрировать: зарегистрированный
заслуга: заслуги
заслужить: заслуженные заслуженный
заявление: заявление
збекча: збекча
звание: звания
земля: земля
знак: знак
знамя: знамени
золотой: золотая
избранный: избранные
издание: издания
изображение: изображениями
изобразительный: изобразительного изобразительное изобразительных
ильич: ильича
империя: империя
имя: имени имя имён
институт: институт
инструмент: инструменты
искусство: искусств искусства искусство
использование: использования
иссык: иссык
история: история
источник: источник
июнь: июня
й: й
кавалер: кавалеры
кара: кара
картина: картин картина
категория: категории
кирг: кирг
киргизия: киргизии
киргизский: киргизская киргизский киргизских киргизского киргизской
кладбище: кладбище
книга: книги
код: код
кодекс: кодекс
колхозный: колхозный
командир: командира
конфиденциальность: конфиденциальности
короткий: короткий
корреспондент: корреспондент корреспонденты
кпсс: кпсс
красный: красного
крымов: крымова
кук: куки
куль: куле
кыз: кыз
кыргызстан: кыргызстана
кыргызча: кыргызча
лауреат: лауреат лауреаты
лейтенант: лейтенант
ленин: ленина
летие: летия
лицензия: лицензии
м: м
малдыбаев: малдыбаева
марк: марка
марка: марке
мастерская: мастерской
материал: материал
мах: маху
медаль: медаль медалью
место: место
мобильный: мобильная
монументалист: монументалисты
монументальный: монументальных
московский: московское московском
мочь: могут
музей: музей
музыкально: музыкально
мы: нами
н: н
навигация: навигации навигация
награда: награды
наградить: награждённые
народный: народные народный
недоступный: недоступная
некоммерческий: некоммерческой
некрополистик: некрополистика
нерабочий: нерабочими
новый: новые
нська: нська
ныне: ныне
областной: областном
область: области область
обсуждение: обсуждение
ознаменование: ознаменование
окончить: окончил
окрестность: окрестности
октябрьский: октябрьской
описание: описание
организация: организации
орден: орден ордена
ответственность: ответственности
отдельный: отдельного отдельной отдельных
отечественный: отечественной
отказ: отказ
отредактировать: отредактирована
отставка: отставке
оформить: оформил
ошибка: ошибке
ошский: ошский ошской ошском
п: п
память: памяти
педагог: педагог педагоги
педагогический: педагогическом
пейзаж: пейзажей
пейзажист: пейзажисты
первый: первых
перейти: перейти
персоналия: персоналии
персональный: персональные
печать: печати печать
победа: победу победы
поведение: поведения
подробный: подробнее
пожертвовать: пожертвовать
поиск: поиск поиску
полдень: полдень
политика: политика
политработник: политработники
политчасть: политчасти
полный: полных
полотно: полотен
получить: получить
портрет: портретов
портретист: портретисты
последний: последний
постановщик: постановщик
постоянный: постоянная
похоронить: похороненные
похоронный: похоронен
почтовый: почтовой
почёт: почёта
поэтичный: поэтичных
править: править
правка: правки
правление: правления
председатель: председатель председателя
представиться: представились
премия: премии премия
преподавать: преподавал
примечание: примечания
проект: проектах
просвещение: просвещения
просмотр: просмотры
пространство: пространства
профессиональный: профессиональных
пулемётный: пулемётной
р: р
работа: работ
развитие: развития
разработчик: разработчики
район: района
ранить: ранен
реализм: реализм
революция: революции
ресурс: ресурсы
родиться: род родившиеся родился
рождение: рождении рождения
роспись: росписей
российский: российская
рота: роты
руководить: руководил
русский: русский
русый: рус
ряд: ряда
сайт: сайт
сатылганов: сатылганова
сведение: сведения
свежий: свежие
свободный: свободной
свойство: свойство
связанный: связанные
связаться: свяжитесь
село: селе
сентябрь: сентября
серия: серию
сила: сил
система: системе
скачать: скачать
скончаться: скончался
скрытый: скрытые
словарь: словари
служебный: служебные
случай: случаях
случайный: случайная
смерть: смерти
смотреть: см
событие: события
совет: совета
советский: советский советской
содержание: содержание
создать: создать
созыв: созыва созывов
сообщество: сообщество
сообщить: сообщить
сохранение: сохранением
социалистический: социалистический социалистического
союз: союза
спектакль: спектакли
спокойствие: спокойствия
справка: справка
сср: сср
ссср: ссср
ссылка: ссылка ссылками ссылки ссылкой
сталинградский: сталинградской
старший: старший
старый: старая
статистика: статистика
статья: статьи статья
стиль: стиль
страна: страна страны
страница: страница странице страницу страницы
стрелковый: стрелкового стрелковой
сууский: сууского
сценограф: сценограф сценографы
сюда: сюда
так: т
творческий: творческой
театр: театра
театральный: театрального театральные
текст: текст
текущий: текущие
техникум: техникуме
товарный: товарный
токтогул: токтогул токтогула
третьяковский: третьяковская
тридцать: тридцать
труд: труда
трудовой: трудового трудовую
тулейкен: тулейкен
туркестанский: туркестанское
уезд: уезд уезде
указание: указанием указания
укра: укра
умерший: умершие
условие: условий условия
участвовать: участвовал
участие: участие
участник: участник
училище: училище
учиться: учился
учёба: учёба
учётный: учётную
фамилия: фамилией
фер: фере
ферганский: ферганская
фонд: фонд
форум: форум
фронт: фронте
фрунзе: фрунзе
художественный: художественное художественном
художество: художеств
художник: художник художники художников
цитировать: цитировать
человек: людях
читать: читать
член: член члены
ша: ша
экспорт: экспорт
элемент: элемент
энциклопедия: энциклопедии
эпический: эпического
этот: эта
юго: юго
язык: языках
январь: января
