абдулаев: абдулаев
абдуллаев: абдуллаев абдуллаева
август: августа
автор: автор
авторство: авторства
аз: аза
азерб: азерб
азербайджан: азербайджан азербайджана
азербайджанский: азербайджанская азербайджанский азербайджанских азербайджанского азербайджанской азербайджанском
азим: азим азима
азимзад: азимзаде
академический: академический
академия: академии
алескер: алескера
алиев: алиева
аллея: аллее
алфавит: алфавиту
апрель: апреля
апшерон: апшерон
аракс: аракс
армия: армию
архивировать: архивировано
афганистан: афганистану
ахунд: ахундов
ахундов: ахундова
б: б
бабаев: бабаев
багиров: багировым
бадалбейль: бадалбейли
бадалов: бадалова
бакинец: бакинца
баку: баку
барельеф: барельефа барельефом
бахлулзада: бахлулзаде
белград: белград
бенгальский: бенгальские
берлин: берлин
биография: биографии биография
благодаря: благодаря
больший: большая большие
большой: большой
брюссель: брюсселе брюссель
быть: е
вагиф: вагифа
век: века
версия: версия
верховный: верховного
вечер: вечер
викидать: викиданных
викимедиа: викимедиа
википедия: википедии википедия
викисклад: викисклад викискладе
вклад: вклад
внести: внёс
война: войны
войти: войти
волшебный: волшебные
воспоминание: воспоминания
впечатление: впечатления
время: время
всемирный: всемирной
вургун: вургун вургуна
выпускник: выпускники
выровнять: выровненные
выставка: выставка выставках выставки
гаджибек: гаджибеков
ганди: ганди
герасимов: герасимова
герой: героев
гл: гл
глаз: глазами
го: го
год: года годах годов году лет
город: городов
горький: горький
гостиница: гостиница
государственный: государственная государственной государственный
гражданство: гражданство
график: график графику
графика: графика графики
гусейн: гусейн
гуттузый: гуттузо
гюлистать: гюлистан
гянджевить: гянджеви
далее: д
дата: дата
дворец: дворец
девушка: девушки
дед: деде
действительный: действительный
действовать: действовать
декабрь: декабря
декорационный: декорационной
дели: дели
депутат: депутат депутаты
деятель: деятелей деятели деятель деятеля
деятельность: деятельности
дж: дж
джаббарл: джаббарлы
джавахарлать: джавахарлала
диплом: диплом дипломом
диптих: диптих
дом: дома
дополнительный: дополнительные
доска: доска
доступный: доступен
др: др
другой: других
дружба: дружбы
ещё: ещё
жанр: жанр жанре
женщина: женщины
живописец: живописец
живописный: живописный
живопись: живописи живопись
жить: жил
заглавный: заглавная
зал: зал
заместитель: заместитель
запись: запись
зарегистрировать: зарегистрированный
зарубежный: зарубежные зарубежных
заслуга: заслуги
заслужить: заслуженного заслуженные заслуженный
заступничество: заступничеству
захоронение: захоронения
заявление: заявление
збекча: збекча
звание: звания
зейналабдин: зейналабдин
знак: знак
золотой: золотая золотой
избранный: избранные
изд: изд
изображать: изображающие
изобразительный: изобразительного изобразительное
иллюстратор: иллюстраторы
иллюстрация: иллюстрации иллюстраций
имадеддин: имадеддин
имя: имени имён
индийский: индийская индийское
индия: индии
институт: институт институте
инструмент: инструменты
искендер: искендеров
искусство: искусств искусства искусство
использование: использования
использовать: использующие
история: история
источник: источник
италия: италии
итальянский: итальянские
июль: июля
июнь: июня
кавалер: кавалеры
картина: картин картины
каталог: каталог
категория: категории
китаби: китаби
книга: книг
книжный: книжную
код: код
кодекс: кодекс
конфиденциальность: конфиденциальности
коркут: коркут
короткий: короткий
корреспондент: корреспондент
который: котором
кп: кп
красавица: красавиц
крупный: крупнейшего
кук: куки
культура: культуры
лауреат: лауреата лауреаты
лейли: лейли
ленин: ленина
летний: летнему
лирический: лирические
литература: литература литературой
лицензия: лицензии
лондон: лондоне
м: м
май: мая
манец: манцу
мастер: мастера
мастерская: мастерской
материал: материал
мгха: мгхи
медаль: медали медаль медалью
меджнун: меджнун
медиафайл: медиафайлы
международный: международной
мемориальный: мемориальная
место: место
метро: метро
метрополитен: метрополитены
микаил: микаил микаила
микаиль: микаиля
микаэл: микаэл
мингечаур: мингечаура
мир: мир мира
михаил: михаил
многий: многих
мобильный: мобильная
мозаичист: мозаичисты
мозаичный: мозаичные
монреаль: монреале
монументалист: монументалист монументалисты
монументальный: монументального
моравиа: моравиа
москва: москве
московский: московский московском
мочь: могут
мы: нами
навигация: навигации навигация
награда: награды
наградить: наградило
наджаф: наджафов
направо: направо
народ: народов
народный: народные народный
насий: насими
натюрморт: натюрморта
независимость: независимость
некоммерческий: некоммерческой
неопр: неопр
непонятный: непонятным
нера: неру
низами: низами
новый: новые
нська: нська
ныне: ныне
область: области
образ: образом
обращение: обращения
обсуждение: обсуждение
оглы: оглы
огонь: огни
октябрь: октября
октябрьский: октябрьской
описание: описание
организация: организации
орден: орден ордена
оригинал: оригинала
основа: основе
ответственность: ответственности
отдельный: отдельных
отказ: отказ
отредактировать: отредактирована
оформить: оформил оформлены
ошибка: ошибке
память: память
панно: панно
париж: париж
педагог: педагог педагоги
пейзаж: пейзажа
пейзажист: пейзажисты
пекин: пекин
первый: первым
перейти: перейти
перечисление: перечислением
персоналия: персоналии
персональный: персональные
печать: печати печать
пианист: пианист
писатель: писателей
поведение: поведения
подробный: подробнее
пожертвовать: пожертвовать
поиск: поиск поиску
политика: политика
получить: получить
польша: польше
портрет: портрет портрета портреты
портретист: портретисты
последний: последний
постоянный: постоянная
похоронить: похороненные
похоронный: похоронен
почётный: почётного почётные
поэма: поэме
правительство: правительство
править: править
правка: правки
прага: прага
председатель: председателя
представиться: представились
премия: премии премия
преобладать: преобладают
преподаватель: преподаватели
преподавать: преподавал
призвать: призван
примечание: примечания
проект: проектах
произведение: произведений произведения произведениям
просмотр: просмотры
пространство: пространства
профессор: профессор
проходить: проходили
прохоров: прохоров
путешествие: путешествий
путешествовать: путешествовал
р: р
работа: работа работы
работать: работал
раджастан: раджастана
развитие: развитии
разработчик: разработчики
рах: рах
революция: революции
ред: ред
результат: результате
резчик: резчик
река: рекой
репрессия: репрессий
рзы: рзы
рисовод: рисоводы
рисунок: рисунки рисунков
родиться: род родившиеся родился
рождение: рождения
российский: российской
руководить: руководил
русский: русский
ряд: ряде
сабир: сабира
самед: самед
сведение: сведения
свежий: свежие
свободный: свободной
связанный: связанные
связать: связано
связаться: свяжитесь
секретарь: секретарём
семь: семь
сентябрь: сентября
серебряный: серебряная
серия: серии серия
система: системе
скачать: скачать
скончаться: скончался
скрытый: скрытые
слева: слева
служебный: служебные
случай: случаях
случайный: случайная
смерть: смерти
смотреть: см
событие: события
совет: совета
советский: советская советский
содержание: содержание
создать: создал создать
созыв: созыва созывов
сообщество: сообщество
сообщить: сообщить
сост: сост
сохранение: сохранением
спастись: спасся
справа: справа
справка: справка
среди: среди
сср: сср
ссср: ссср
ссылка: ссылка ссылки
станция: станции станция
статистика: статистика
статья: статьи статья
столетний: столетний
страна: странам
страница: страница странице страницу страницы
строитель: строители
суриков: сурикова
сценограф: сценограф сценографы
счастие: счастья
сюда: сюда
сюжет: сюжетов
так: т
также: также
такой: такие
татарча: татарча
творческий: творческой
творчество: творчестве творчество
театрально: театрально
театральный: театральные
текст: текст
текущий: текущие
тема: темы
тесно: тесно
техникум: техникуме
товарный: товарный
тридцатый: тридцатых
узеир: узеир
указание: указанием
указать: указан
укра: укра
умерший: умершие
университет: университета
условие: условий условия
установить: установлена
участие: участие
училище: училище
учиться: учился
учёба: учёба
учётный: учётную
ф: ф
фаворский: фаворской
фамилия: фамилией
фасад: фасаде
февраль: февраля
физули: физули
фонд: фонд
форум: форум
фоторяд: фоторяды
хамса: хамсе
хачмас: хачмаса
хосров: хосров
художественный: художественное художественном художественный
художество: художеств
художник: художник художника художники художников
цикл: цикл
цитировать: цитировать
цк: цк
частность: частности
чекмазов: чекмазова
человек: людях
читать: читать
член: член членов члены
ша: ша
ширин: ширин
э: э
экспонироваться: экспонировались
экспорт: экспорт
элемент: элемент
энциклопедия: энциклопедии энциклопедия
эпос: эпосу
этот: эта
юбилей: юбилею
язык: язык языках
январь: января
