авангард: авангарда
август: августа августе
авт: авт
автор: автор автора авторы
авторство: авторства
агентство: агентство
адрес: адреса
аз: аза
аиф: аиф
академический: академический академического
академия: академии академия
аки: аки
аким: акимов
акимов: акимова акимову
акимовский: акимовского
актриса: актриса
актёр: актёры
актёрский: актёрская
алек: алек
александр: александр
александринский: александринский
али: али
алфавит: алфавиту
альбом: альбом
альманах: альманах
алёшин: алёшина
анатолиевич: анатольевич
англ: англ
андрушкевич: андрушкевичем
анкетирование: анкетирование
анна: анна
анри: анри
антокольский: антокольского
апрель: апреля
арбузов: арбузова
аросев: аросева
арт: арт
артист: артист артисты
арх: арх
архивировать: архивировано
архивный: архивные
архитектор: архитектор
архитектура: архитектура
аста: аст
афиногенов: афиногенова
афиша: афиши
ахматов: ахматова
б: б
байрон: байрона
балаганчик: балаганчик
бартошевич: бартошевич
басовый: басова
бдт: бдт
белецкий: белецкого
белый: белый
берггольц: берггольц
берлин: берлина
бессмертный: бессмертный
библиографический: библиографических
биография: биографии биография
благочестивый: благочестивая
блажек: блажека
бланша: бланш
блестящий: блестящим
богатство: богатство
богданов: богданова
богуславский: богуславским
больной: больные
больший: большая
большой: большого большой большом
бонди: бонди
борисовский: борисовская
боровецкий: боровецкого
борьба: борьбы
бост: боста
боёк: бойком
брак: брака
брать: брал
бронепоезд: бронепоезд
брюллов: брюллова
брюссель: брюсселе
бубусы: бубус
будущее: будущем
бунт: бунт
бурлак: бурлак
български: български
быть: е
валенсианский: валенсианская
вахтангов: вахтангова
вдова: вдова
вега: вега веги
ведущий: ведущих
вейсбрёма: вейсбрёма
век: век века
великий: великого великой
вержбицкий: вержбицкий
вернейль: вернейля
вернуться: вернулся
версия: версии версия
верховный: верховного
весна: весна весной
вести: вела
весь: весь
вечер: вечер
вечерний: вечерний вечерних
взгляд: взгляд
викидать: викиданных
викимедиа: викимедиа
викиновость: викиновости
википедия: википедии википедия
вильвовский: вильвовская
виндаво: виндаво
виталий: виталий
вклад: вклад
вл: вл
владимир: владимир
влович: влович
вместе: вместе
внешний: внешние
внешность: внешность
водевиль: водевилей
возвращаться: возвращаюсь
возможно: возможно
война: войне войны
войтенко: войтенко
войти: войти
волковский: волковском
волшебный: волшебные
вольный: вольной
вольпин: вольпина
вопрос: вопрос вопросам
враг: враги врагов
время: времени время
всемирный: всемирной
вскоре: вскоре
вст: вст
вступа: вступ
всякий: всякого
вто: вто
второй: вторая
вхутемас: вхутемас вхутемаса
выдвинуть: выдвинули
вызвать: вызвала
выйти: вышел
вынужденный: вынужденным
вып: вып
выпуск: выпуск выпуски
выпускник: выпускники
высокий: высших
выставить: выставлен
выставка: выставка выставке выставки выставку
г: г
гавричок: гавричков
газета: газета
галаджевой: галаджевым
галерея: галерею
гамлет: гамлет гамлета гамлете
гарин: гариным
гастроль: гастролей
генеалогия: генеалогия
гений: гением
георгий: георгием
геркулес: геркулеса
гиндин: гиндина
гл: гл
глава: глава главе
главный: главный
гладков: гладкова
гнездо: гнездо
гоголь: гоголя
год: гг год года годах годов году годы лет
голод: голодом
гонимый: гонимый
город: город
горький: горького
гос: гос
господин: господин
государственный: государственного государственном государственный
гражданство: гражданство
график: график
графика: графика графики
графический: графические
грим: грима
гурыч: гурыч
гусев: гусева
гусиный: гусиное
гутман: гутманом
давать: даёшь
давно: давно
давный: давным
далее: д
дата: дата
датский: датская
двенадцатый: двенадцатая
дворянский: дворянское
де: де
девственный: девственный
девушка: девушки
действие: действиях
действовать: действовать
декабрь: декабря
декорационный: декорационного
декорация: декорации
дело: дело
день: дней
дерево: деревья
деятель: деятелей деятели деятель
дж: дж
джон: джон
дикий: дикого
дипломат: дипломаты
директор: директор директору
длинный: длинных
длительный: длительного
доблестный: доблестный
добужинский: добужинского
довольно: довольно
документ: документы
документальный: документальный
дом: дом доме
дон: дон
доп: доп
дополнительный: дополнительные
дораб: дораб
дорога: дороги
доска: доска
доступный: доступен
досье: досье
дочь: дочери
др: др
дракон: дракон
драма: драма драмы
драматический: драматический драматического драматическом
драматург: драматургом
драматургия: драматургия
друг: друзья друзьях
другой: другие других
дубровский: дубровский
душа: душу
душанбе: душанбе
дышленко: дышленко
евг: евг
евгений: евгений евгения
евграф: евграф
евреинов: евреинов евреинова евреиновым
европейский: европейская
еженедельник: еженедельником
елена: елена елены
ермил: ермилов
ещё: ещё
её: её
жанр: жанра
желание: желание
железнодорожный: железнодорожного
железный: железной
жена: жена
женитьба: женитьба
живописный: живописные
жизнь: жизни жизнь
жильбер: жильбера
жить: живу жил
жуан: жуан
журнал: журнал
жюля: жюля
з: з
заболотный: заболотней
забыть: забудете
завершить: завершил
завершиться: завершилась
заглавный: заглавная
заговор: заговор
зазеркалье: зазеркалья
зайденберг: зайденберга
заказ: заказам
заметка: заметки
заниматься: занимался
занятие: занятий
запись: запись
запомнить: запомните
запретить: запрещён
зарегистрировать: зарегистрированный
заслужить: заслуженные заслуженный
затем: затем
захава: захавы
заявление: заявление
звание: звания
звезда: звезды
звонок: звонок
звёздный: звёздный
зебра: зебра
зеленин: зеленина
зеркало: зеркало
злословие: злословия
знак: знак
знамя: знамени
значительно: значительно
золушка: золушка
иван: иван
иванов: иванов иванова ивановым
иванович: иванович
игорь: игорь
избранный: избранные
известие: известия
изд: изд
издание: издание
издательство: издательства издательстве
издать: изданный
изобразительный: изобразительного изобразительное изобразительному
изобретательность: изобретательность
изобретательный: изобретательный
ик: ик
ил: ил
иллюстратор: иллюстратор иллюстраторы
иллюстрация: иллюстрации
иллюстрировать: иллюстрированный
империя: империя
импонировать: импонировала
имя: имена имени имя имён
ин: ин
институт: институт института институте
инструмент: инструменты
инсценировка: инсценировка
интерактивный: интерактивное
интервью: интервью
инфаркт: инфаркта
иск: иск
искатель: искатель
искусство: искусств искусства искусство искусству
искусствовед: искусствоведа
использование: использования
использовать: использующие
испр: испр
исторический: исторические
история: истории история
источник: источник источниками источников
июль: июля
й: й
кабальеро: кабальеро
кабаре: кабаре
кабинет: кабинет
кавалер: кавалеры
каверин: каверина
кадр: кадры
казанский: казанским
кальдерон: кальдерона
каплан: каплан
карваша: карваша
карта: карт
картина: картины
карусель: карусель
касон: касоны
катаев: катаева
каталог: каталогах
катастрофа: катастрофа
категория: категории
кауфман: кауфмана
кац: кац
качество: качестве
кащи: кащей
квартира: квартиру
кернер: кернер
килти: килти
кинематография: кинематографии
кино: кино
кинорежиссёр: кинорежиссёр
киностудия: киностудии
киносценарий: киносценарию
кирпичный: кирпичного кирпичный
кладбище: кладбища кладбище
класс: классах
классика: классики
книга: книга
книжный: книжные книжный
кобак: кобак
кобылина: кобылина
ковалевский: ковалевская
коварство: коварство
код: код
кодекс: кодекс
козловский: козловским
кокель: кокель
комедиант: комедиантов
комедия: комедии комедия
комедь: комеди
комната: комната комнату
композиция: композиция
конец: конец конца конце
конфиденциальность: конфиденциальности
королева: королевы
король: король
короткий: короткий
короткометражный: короткометражный
корф: корфа
косарев: косарев
космополитизм: космополитизмом
костюм: костюмы
который: которая которой которые
кочегар: кочегаром
кошеверов: кошеверова кошеверовой
кравец: кравец
красноярск: красноярске
красный: красная красного красной
кременцов: кременцова
креолка: креолка
кресло: кресло
кречинский: кречинского
кривой: кривое
криворыльск: криворыльска
критик: критик
критика: критика
кровь: крови
кроленко: кроленко
кроль: кроля
крона: крона
кругосвета: кругосвет
кружок: кружок
крыжицкий: крыжицким крыжицкого
кубасовый: кубасов
кук: куки
кулак: кулаков
кулешов: кулешова
культура: культура культуре культуры
кумир: кумира кумиры
купить: купить
курс: курсах
л: л
лабиш: лабиша
лаборатория: лаборатории
лаврентьев: лаврентьева лаврентьевым
лавренёв: лавренёва
лгитмик: лгитмик
лебзак: лебзак
лев: лев
левидовой: левидовой
легар: легара
ленингра: ленингр
ленинград: ленинград ленинграда ленинграде
ленинградский: ленинградская ленинградский ленинградских ленинградского ленинградском ленинградскому
леннаучфильм: леннаучфильм
ленский: ленского
ленсовет: ленсовета
леонов: леонова
лес: лес
летие: летия
лившицо: лившицом
лидия: лидия
липа: липами
литератор: литераторы
литераторский: литераторских
литература: литература
литературный: литературные
литовский: литовская
лицензия: лицензии
лицо: лица
ложь: ложь
лоп: лопе
лунгин: лунгина
львович: львович
любимов: любимов
любовь: любви любовь любовью
люля: люль
м: м
мазуров: мазурова
май: мая
макет: макет
максимов: максимова
малкин: малкиным
малый: малая
мальчик: мальчик
малюгин: малюгина
малютка: малютка
маневич: маневич
марк: марк
март: марта
масса: масса
мастер: мастера
мастерская: мастерской мастерскую
материал: материал
матрос: матросом
мать: мать
машина: машина
маяковский: маяковского
медаль: медали медаль медалью
международный: международную
мейерхольд: мейерхольда
мемориальный: мемориальная
место: месте место
милан: милан
милый: милый
мир: мира миру
мирный: мирные
мировой: мирового
миронов: миронова
мистер: мистера
михаил: михаил
михайлов: михайлов
михалков: михалкова
михновый: михнов
мнемозина: мнемозина
мобильный: мобильная
мов: мов
могила: могила
мокульский: мокульского
молин: молины
молодой: молодом молодому молодых
молодость: молодость
молодёжный: молодёжного
морской: морская
морщихина: морщихина
москва: москва москве москву
московский: московский московском
московско: московско
мосток: мостках
мочь: могут
мстиславский: мстиславского
мудрец: мудреца
музей: музей
музыка: музыкой
музыкальный: музыкальной
мурзина: мурзин
мутан: мутанов
мхат: мхат
мы: нами
мюзик: мюзик
н: н
набережная: набережная
навигация: навигации навигация
награда: награды
наградить: награждённые
надгробие: надгробие
надежда: надежда
наклейка: наклейками
народный: народные народный
наряду: наряду
наследие: наследие
настоящий: настоящем
научий: науч
научный: научный
начало: начало началом
начать: начал
небольшой: небольшой
неизвестный: неизвестен
некоммерческий: некоммерческой
некрасов: некрасовым
некрополистик: некрополистика
некрылов: некрылова
нелёгкий: нелегкий
немой: нем немой
неодобрение: неодобрение
неопр: неопр
непременно: непременно
нераспознанный: нераспознанным
нерв: нервы
нивуа: нивуа
ние: ние
никитченко: никитченко
никола: никола
николай: николаем николай николаю николая
нина: нина
ниспровергатель: ниспровергатель
новость: новости
новый: новая нового новой новые новый
нога: нога
ночной: ночного ночной
ночь: ночь
ноябрь: ноября
нська: нська
нужда: нуждой
нур: нур
нусиновый: нусинова
ныне: ныне
обложка: обложки
обманщик: обманщик
обозрение: обозрений
оборона: оборону
обращение: обращения
обсуждение: обсуждение
общество: общества
объект: объекта
обыкновенный: обыкновенное обыкновенный
овэс: овэс
оглавление: оглавление
один: одной
однако: однако
озеро: озеро
оказаться: оказался
окончание: окончание
окончить: окончила
октябрь: октябрь октября
окунь: окунь
олег: олег
олеша: олеши
ольга: ольга
онлайн: онлайн
опасный: опасный
оперетта: оперетты
описание: описание
опытный: опытными
организация: организации
орден: орден ордена
осень: осенью
осипов: осипов
основа: основе
основатель: основатель
особо: особо
останавливаться: останавливается
остров: остров
островский: островского
остроумие: остроумие
остроумный: остроумный
отв: отв
ответ: ответ
ответственность: ответственности
отд: отд
отделение: отделения
отдельный: отдельных
отец: отец
отечественный: отечественной
отказ: отказ
открыть: открыли открыта
отличаться: отличаться
отметить: отмечена
отредактировать: отредактирована
офицер: офицер
официальный: официальный
оформительский: оформительские
оформить: оформил
оформление: оформление оформлением оформлении
оффенбах: оффенбаха
охлопков: охлопков
охотник: охотник
очерк: очерки
ошибка: ошибке
п: п
па: па
павильон: павильон
павлович: павлович
память: памяти память
панов: пановой
паньоля: паньоля
париж: париж
партия: партия
педагог: педагог педагоги
пейра: пейре
пер: пер
первый: первая первой первом
переехать: переехала
перейти: перейти
переполох: переполох
переулок: переулка переулок
перо: перо
перришон: перришона
персоналия: персоналии
персональный: персональная персональные
перспектива: перспективы
петербург: петербург петербурга петербурге
петербургский: петербургский
петров: петрова петрову петровым петровыми
петровский: петровская
петроград: петроград петрограда петрограде
петроградский: петроградским
печать: печати печать
пигмалиона: пигмалион
пик: пик
пионер: пионеров
пиотровский: пиотровского
пирютко: пирютко
писатель: писатели
писать: пишет
плакат: плакат плаката плакатов
плакатист: плакатист плакатисты
плодотворный: плодотворный
площадка: площадка
поведение: поведения
повесть: повесть
повод: поводу
поворот: поворот
подвиг: подвиги
подробный: подробнее
пожертвовать: пожертвовать
поздний: позже
познакомить: познакомил
поиск: поиск поиску
пока: пока
показ: показов
покинуть: покинул
политика: политика
политпросветработник: политпросветработников
получить: получить
понедельник: понедельник
поощрение: поощрения
попов: попова
портр: портр
портрет: портретов
портретист: портретист портретисты
портфель: портфелем
посадский: посадская
посвятить: посвященный
послать: послан
последний: последнее последний
поставить: поставленному поставленные поставленный
постановка: постановка постановке
постановочный: постановочного постановочный
постоянный: постоянная постоянной
поступить: поступил
потрясти: потрясли
похищение: похищение
похоронить: похороненные
похоронный: похоронен
почувствовать: почувствовал
правда: правда
править: править
правка: правки правок
правление: правлении
председатель: председатель
представить: представил представлены
представиться: представились
представление: представлении представления
президиум: президиума
премьера: премьера
преподаватель: преподаватели
преподавать: преподавал
прервать: прервав
пригожина: пригожина
призрак: призраки
приключение: приключений
примеч: примеч
примечание: примечания
принадлежать: принадлежат
присвоить: присвоено
пристлить: пристли
присутствовать: присутствовали
проверить: проверенной
проверка: проверки
проверяться: проверялась
продавец: продавцы
продажа: продаже
продолжаться: продолжалось
продолжение: продолжение
проект: проектах
произведение: произведениям
пройти: прошла
пролеткульт: пролеткульта
просмотр: просмотры
простота: простоты
пространство: пространства
профессиональный: профессиональных
профессия: профессия
профессор: профессор
проходить: проходившей
прохоров: прохорова
прочий: прочих
психологический: психологического
публа: публ
публицист: публицист публицисты
пустой: пустую
путешествие: путешествие
путь: пути
пушкин: пушкина
пушкинский: пушкинской
пьер: пьера
пёстрый: пёстрые
р: р
работа: работа работами работой работу работы
работать: работал работала работать работаю
радиодетектив: радиодетектив
радлов: радлова
развернуть: развёрнутая
разгар: разгар
разговор: разговор разговоре
разлом: разлом
разработка: разработка
разработчик: разработчики
разруха: разрухой
райхштейн: райхштейн
ракитин: ракитин
рамт: рамт
раневский: раневская
рапопорт: рапопорт
раскольник: раскольников
рассказ: рассказ рассказы
расстаться: расстались
расти: рос
ребёнок: детей
ревизор: ревизор
революция: революции
ред: ред
редактор: редактор
редакция: редакция
реж: реж
режиссёр: режиссёр режиссёра режиссёром режиссёру режиссёры
режиссёрский: режиссёрская режиссёрские режиссёрской
ремез: ремезом
ремизов: ремизовой
ренье: ренье
реплика: реплика
ресурс: ресурсы
риия: риии
рисовальный: рисовальных
рисунок: рисунок
рнб: рнб
робеспьер: робеспьер
робинзона: робинзона
родиться: род родившиеся родился
родственный: родственную
рождение: рождения
роль: ролях
ромашов: ромашова
ромен: ромена
российский: российская российский российского
россия: россии россия
рсфср: рсфср
ру: ру
рубен: рубена
руководитель: руководителем
руководство: руководством
русский: русская русский русского
русый: рус
руфома: руфом
рыбинский: рыбинской
рябкина: рябкина
ряд: ряд
сайт: сайт сайты
салтыков: салтыкова
самостоятельный: самостоятельной
самоучка: самоучек
самый: самый
санкт: санкт
сапёрный: сапёрный
сарабьян: сарабьянов
сартр: сартра
сатир: сатире
сатира: сатиры
сблизиться: сблизился
сборник: сборник
свадьба: свадьба
сведение: сведения
свежий: свежие
свердловск: свердловск
свирин: свирина
свободный: свободной
свой: своей своем
связанный: связанные
связаться: свяжитесь
святыня: святыня
сегодня: сегодня
сезон: сезон сезоне
село: село
семья: семье семья
семёнович: семёновна
сена: сене
сентябрь: сентября
серебряков: серебрякова
серебряный: серебряной
серия: серии
симоново: симонова
синичкин: синичкин
синтетический: синтетический синтетическом
синяков: синякова
система: системе
сказка: сказке
скачать: скачать
скончаться: скончался
скрытый: скрытые
скульптор: скульптор
слава: славы
славина: славин
сладков: сладков
словарь: словари словарь
служащий: служащего
служебный: служебные
случай: случай случаях
случайный: случайная
случиться: случилось
смена: смена
смерть: смерти
смотреть: см
сначала: сначала
снежный: снежной
соавторство: соавторстве
собака: собака
событие: события
соважон: соважона
совет: совета
советский: советская советские советский советского советское советской
совместно: совместно
совместный: совместной
современность: современность
современный: современной современном современные современный
содержание: содержание содержании
создавать: создавал
создание: создании
создать: создал создано создать
соловьёв: соловьёвым
солодовников: солодовникова
сообщество: сообщество
сообщить: сообщить
сост: сост
составитель: составители составитель
составить: составили
состояться: состоялась состоялись
сотворить: сотвори
сотрудничать: сотрудничал
сотрудничество: сотрудничества сотрудничество
софья: софья
сохранение: сохранением
сочетание: сочетании
сочинение: сочинения
спб: спб
спбгать: спбгати
спектакль: спектакле спектаклей спектаклем спектакли спектакль спектаклю спектакля
спецтранс: спецтрансе
справка: справка
спрятать: спрятанный
спутник: спутники спутников
сср: сср
ссср: ссср
ссылка: ссылка ссылки
ставить: ставит
сталинабад: сталинабад
сталинград: сталинград
станковый: станковые
старый: старая старые
статистика: статистика
стать: стал стало статей
статья: статьи статья
стихия: стихии
сторона: стороны
стоя: стоя
стр: стр
страна: стране
страница: страница странице страницу страницы
страх: страх
страшный: страшный
стрекоза: стрекоз
строка: строк
струтинский: струтинская
студия: студии
суд: суд
супруг: супругах
суханов: сухановым
сухаревский: сухаревская
суховый: сухово
схш: схш
сцена: сцене
сценарист: сценарист
сценарный: сценарная
сценический: сценическая сценических сценической
сценограф: сценограф сценографа сценографы
сценография: сценография
сыркина: сыркина сыркиной
сэр: сэр
сюда: сюда
таджикский: таджикской
так: т
такой: такая
танец: танец
тартюф: тартюфа
татьяна: татьяна
тверской: тверского
творчество: творчества творчестве творчество
театр: театр театра театре театром театру
театрально: театрально
театральный: театральная театрального театральное театральной театральном театральному театральные театральный театральным театральных
театрон: театрон
текст: текст текстом
текущий: текущая текущие
тематический: тематические
тенина: тенин
тень: тени тень
теоретик: теоретиком
терентий: терентий
тимошенко: тимошенко
тип: тип
товарищ: товарищах
товарный: товарный
товстоногов: товстоногова
толлера: толлера
толчановый: толчанова
тонкий: тонкое
травля: травля
трагедия: трагедии
традиционный: традиционного
тракать: тракал
трактовка: трактовка
трансформировать: трансформирующий
требовать: требуют
тренёв: тренёва
третий: третье третья
трехминутный: трехминутный
три: трёх
тройка: тройка
трофименков: трофименков
труд: труд
трудность: трудности
трудовой: трудового
тур: тура туром
тут: туту
тюльпан: тюльпанов
уайлёд: уайльда
угрюмов: угрюмова
удостоить: удостоен
уехать: уехал
уйти: ушла
указ: указ
указание: указанием
указать: указан
укра: укра
украина: украины
украинский: украинская
укрощение: укрощение
ул: ул
улица: улица улице
умереть: умер
умерший: умершие
умирать: умирают
универсальный: универсальная
урок: уроки
условие: условий условия
условность: условность
установить: установлена
утверждение: утверждениями
уход: уходом
участвовать: участвовал
участие: участие
участник: участниками
ученик: ученик учениками ученики
учитель: учитель
учиться: училась учился
учёба: учёбу
учётный: учётную
ф: ф
файко: файко
факультет: факультет
фальстафа: фальстаф
фамилия: фамилией
фантазия: фантазии
февраль: февраля
федёр: федер
фербер: фербер
филиал: филиала
филиппо: филиппо
фильм: фильм
фильмография: фильмография
флорида: флорида
флот: флота
фойе: фойе
фонд: фонд фонда
форма: форме
форум: форум
франсез: франсез
фронт: фронту
х: х
ханзель: ханзелем
харьков: харьков харькове
харьковский: харьковский
хейфице: хейфицем
холл: холл
холод: холодом
хонина: хонин
хороший: лучших
хохлов: хохлова
хроника: хроника
худож: худож
художественно: художественно
художественный: художественной художественный художественным
художество: художеств
художник: художник художника художнике художники художников художником художнику
хх: хх
царский: царское
цв: цв
цдрить: цдри
целковы: целков
центральный: центральная
центрполиграф: центрполиграф
цилиндр: цилиндр
цитировать: цитировать
цуцульковский: цуцульковским
частный: частной
чежеговый: чежеговым
человек: людей люди людях человек
чемодан: чемодан
червинский: червинского
черкасов: черкасов
черкасский: черкасский
честной: честных
чехов: чехова чехову
число: числе число
читать: читать
чувство: чувств
чудо: чудо
ша: ша
шаланда: шаландах
шапиро: шапиро
шапьюй: шапьюи
шварц: шварц шварца
шекспир: шекспира
шеридать: шеридана
шиллер: шиллера
широта: ш
шкваркина: шкваркина
школа: школа школы
шостакович: шостаковича
шоу: шоу
шундик: шундика
шутить: шутят
шутка: шутки
шухаев: шухаева
щедрин: щедрина
э: э
эвакуироваться: эвакуировался
эдуард: эдуарда
экз: экз
экспериментальный: экспериментальной
экспорт: экспорт
эксцентрический: эксцентрического
элемент: элемент
энциклопедия: энциклопедии энциклопедия
эпитет: эпитеты
эпоха: эпоха
эрдмана: эрдмана
эскиз: эскизам
эстамп: эстампов
эстрадный: эстрадных
эткинд: эткинд
это: это
этот: эта
ю: ю
юнгера: юнгер
юношество: юношества
юрий: юрий
язык: язык языках языком
яковлев: яковлева
январь: января
янковский: янковский
яровой: яровая
ястребенецкий: ястребенецкий
