автор: автором
авторство: авторства
академия: академии академия
акселос: акселос
акселоса: акселоса
аксесть: аксело
алфавит: алфавиту
амфиктиония: амфиктионии
английский: английский
антигона: антигон
архивировать: архивировано
архивный: архивная
афинский: афинская афинского афинском афинскую
афины: афинах афины
базилевс: базилевс
банк: банка
биенале: биенале
биография: биография
благословенный: благословенный
богиня: богини
болгарский: болгарской
будущее: будущего
век: век века
великий: великих
венецианский: венецианской
версия: версия
викатос: викатоса
викидать: викиданных
викимедиа: викимедиа
википедия: википедии википедия
вклад: вклад
вне: вне
вода: водами
водный: водный
военачальник: военачальника военачальников
возглавлять: возглавлял
возродить: возрождённого
война: войны
войти: войти
восток: востоке
выставить: выставлены
выставка: выставка выставках выставке
выставляться: выставляются
галерея: галерее
георгий: георгия
гераниотис: гераниотиса
германо: германо
год: года годов году годы лет
голова: голова
город: города городе
государство: государства
гранд: гранд
греция: греции греция
греча: греч
греческий: греческая греческий греческих греческого греческое греческой
греческо: греческо
групповой: групповых
густой: густой
дата: дата
два: двумя
дворец: дворце
дед: дед
действовать: действовать
декабрь: декабре декабря
дельфийский: дельфийской
деметр: деметры
день: дня
департамент: департамент
держава: держав
десятилетие: десятилетий
деятель: деятели
деятельность: деятельности
димитрий: димитрия
доминировать: доминирующим
дополнительный: дополнительные
досон: досон
достоинство: достоинством
доступный: доступен
драхма: драхм
древний: древней
другой: других
ещё: ещё
жан: жан
жанр: жанр
живопись: живопись
жюлиан: жюлиана
заглавный: заглавная
заголовок: заголовком
запись: запись
заполнить: заполнить
заппион: заппион
зарегистрировать: зарегистрированный
затем: затем
заявление: заявление
здоровый: здоровым
знак: знак
зрение: зрения
избранный: избранные
известно: известно
изображение: изображениями
изобразительный: изобразительного
изобразить: изображена изображён изобразил
изящный: изящных
именовать: именует
импрессионизм: импрессионизм импрессионизма
имя: имён
инструмент: инструменты
ионий: ионии
искусство: искусств искусства
использование: использования
исторический: исторической
история: история
источник: источник
италия: италии
италый: итало
июль: июля
июнь: июне июня
й: й
каждодневный: каждодневного
картина: картине картины
категория: категории
климат: климатом
км: км
код: код
кодекс: кодекс
коллекция: коллекциях
колония: колонии
колос: колос
композиция: композиции
константинос: константинос
контроль: контролем
конфиденциальность: конфиденциальности
копия: копией копия
королевство: королевство
коронить: корони
короткий: короткий
который: которой которую
край: край
крит: крит крите
кук: куки
культура: культуры
культурный: культурных
л: л
лицевой: лицевая лицевой
лицензия: лицензии
лоран: лорана
май: мая
македонский: македонской
малярия: малярии
март: марта
материал: материал
местный: местная
место: место
метапонт: метапонт
министерство: министерства
мир: мирами
михаил: михаил михаила
михая: михаи
многий: многих
мобильный: мобильная
мольберт: мольберт
монета: монет монета монете монеты
морской: морской
мочь: могут
музей: музее музей
мы: нами
н: н
наблюдаться: наблюдалась
навигация: навигации навигация
назначить: назначен
написать: написал написанных
насильственный: насильственный
настояние: настоянию
находиться: находившегося находилась
национальный: национального национальной
начальный: начальное
незадолго: незадолго
некоммерческий: некоммерческой
неопр: неопр
несколько: несколько
никелевый: никелевой
новый: новой новые
область: области
образование: образование
обратный: обратной
обращение: обращения
обстроить: обстроил
обсуждение: обсуждение
общественность: общественность
один: одним
оккупация: оккупации
окончание: окончании
окончить: окончил
окрестность: окрестностей
описание: описание
организация: организации
организовать: организовал
оригинал: оригинала
освободительный: освободительной
осман: османами
османский: османским османской
остаться: остался
остров: остров острова острове
отблагодарить: отблагодарить
ответственность: ответственности
отдельный: отдельных
отец: отец
отказ: отказ
отправиться: отправился
отредактировать: отредактирована
охарактеризовать: охарактеризован
ошибка: ошибке
память: память
панэллинский: панэллинской
париж: париже
пейзаж: пейзажей пейзажи
пелопоннес: пелопоннеса
первоначально: первоначально
перебраться: перебрался
перейти: перейти перешёл
период: период
персоналия: персоналии
персональный: персональные
печать: печати печать
писать: писал
поведение: поведения
повстанец: повстанцев
подданство: подданство
подробный: подробнее
пожертвовать: пожертвовать
поздний: позже
поиск: поиск поиску
поле: поля
политика: политика политики
получить: получил получить
поныне: поныне
портрет: портреты
послевоенный: послевоенной
последний: последний
постановление: постановлением
постепенно: постепенно
постоянный: постоянная
поступить: поступил
правитель: правителем
править: править
правка: правки
предел: пределов
представиться: представились
принять: принял
продолжить: продолжил
проект: проектах
прожить: прожил
произведение: произведением
просмотр: просмотры
пространство: пространства
пшеница: пшеницы
работа: работ работу работы
разработчик: разработчики
рамка: рамках
революция: революции
редкий: редкого
родиться: род родившиеся родился
рождение: рождения
ройлоса: ройлоса
русс: русса
русский: русский
рядовой: рядового
сведение: сведения
свежий: свежие
свободный: свободной
свой: своей своим
свойство: свойство
связанный: связанные
связаться: свяжитесь
северо: северо
село: село
семья: семьёй
сентябрь: сентября
серебряный: серебряных
сила: силу
система: системе
ситий: ситии сития
скачать: скачать
скрытый: скрытые
скульптор: скульптор
следствие: следствие
служебный: служебные
случай: случаю случаях
случайный: случайная
смерть: смерти
смирна: смирне
смотреть: см
соавтор: соавтором
событие: событии события
содержание: содержание
создать: создать
сообщество: сообщество
сообщить: сообщить
состав: составе
сохранение: сохранением
союз: союза
спиридон: спиридона
справка: справка
ссылка: ссылка ссылки
статер: статера
статистика: статистика
стать: стал
статья: статьи статья
стиль: стиле стиль
столица: столица
сторона: сторона стороны
страница: страница странице страницу страницы
сын: сын
сюда: сюда
текст: текст
текущий: текущие
тема: тему
тематика: тематики
тетрадрахма: тетрадрахмы
товарный: товарный
точка: точки
тройной: тройной
труд: труда
трёхлетний: трёхлетний
тяжёлый: тяжёлые
увековечить: увековечил
указание: указанием
указать: указан
умереть: умер
умерший: умершие
университет: университета
условие: условий условия
участие: участие
учиться: учился
учёба: учёба учёбу
учётный: учётную
факультет: факультет
февраль: февраля
филиал: филиал
фовизмский: фовизмский
фонд: фонд фондов
форум: форум
французский: французской
храниться: хранятся
художественный: художественной художественный
художник: художник художника художники художников художником
цвет: цвет
цитировать: цитировать
частный: частных
чеканить: чеканил
человек: человека
число: числе
чистый: чистыми
читать: читать
школа: школа школу
шомьер: шомьер
э: э
экспозиция: экспозицию
экспорт: экспорт
экспрессионизм: экспрессионизм
экспрессионистский: экспрессионистскому
элемент: элемент элементом
энциклопедия: энциклопедии
эпарх: эпархом
эпидемия: эпидемия
эскиз: эскизы
этот: эта
юг: юге
южный: южной
юридический: юридический
язык: язык языках
яковидис: яковидиса
январь: января
