абанишин: абанишина
абстракционизм: абстракционизма
авторство: авторства
аиф: аиф
академический: академической
акварель: акварелью
алфавит: алфавиту
аннотация: аннотация
армия: армии
арт: арт
арх: арха
архангельский: архангельский архангельского
архивировать: архивировано
архитектура: архитектуры
б: б
балкария: балкарии
библиография: библиография
биография: биография
болгария: болгарии
больница: больнице
больший: большую
бывать: бывали
быть: е
валенти: валенти
валентин: валентином
валентинович: валентинович
варна: варна
ватикан: ватикане
вд: вд
век: века
вернуться: вернулся
версия: версия
ветер: ветер ветром
вечный: вечный
взгляд: взгляд
викидать: викиданных
викимедиа: викимедиа
википедия: википедии википедия
витраж: витражом
вклад: вклад
вместе: вместе
войти: войти
вольнослушатель: вольнослушателем
воробьёв: воробьев
всероссийский: всероссийская
всесоюзный: всесоюзная всесоюзные
выпускник: выпускники
высокий: высшего
выставка: выставка выставке выставки
выставочный: выставочном выставочный
г: г
газета: газета
гала: гал
галерея: галерее галерея
геленджик: геленджик
год: года году годы лет
городской: городской
горячее: горячем
государственный: государственном
графика: графика графикой
греция: грецию
гулькевичи: гулькевичи
далее: д
дар: дар
дата: дата
дать: данная
дача: дачах дачу
действовать: действовать
декабрь: декабря
десятка: десятки
деятельность: деятельности
добавить: добавить
добро: добра
дополнительный: дополнительные
доступный: доступен
другой: других
дышать: дышат
дьюк: дьюка
ездить: ездил
ещё: ещё
жанр: жанр
живопись: живописи живопись
жизнь: жизни
журнал: журнал
з: з
заведение: заведениях
завод: заводе
заглавный: заглавная
зал: зал зале
заметка: заметки
заниматься: занимался
запись: запись
зарегистрировать: зарегистрированный
заявление: заявление
звание: звания
знак: знак
иванович: ивановна
избранный: избранные
известие: известия
изображать: изображал
изобразительный: изобразительных
иметься: имеются
имя: имён
институт: институте
инструмент: инструменты
искусство: искусств
использование: использования
использовать: использующие
история: история
источник: источник источники
кабардино: кабардино
карлово: карлово
картина: картины
картинный: картинной
категория: категории
керамика: керамикой
кипр: кипре
кквзия: кквзии
ключ: ключе
коваленко: коваленко
код: код
кодекс: кодекс
коллаж: коллажем
коллекция: коллекциях
комсомолец: комсомолец
конфиденциальность: конфиденциальности
кореновск: кореновска
короткий: короткий
космизм: космизме
который: которое
краевой: краевом
край: край края
краска: красок
краснодар: краснодар краснодаре
краснодарский: краснодарские краснодарский краснодарского краснодарское краснодарском
красота: красотой
кроме: кроме
крупный: крупной
кубань: кубани кубань
кук: куки
л: л
ленинград: ленинград
ленинградский: ленинградском
лицензия: лицензии
ляд: лядов
м: м
май: май мая
маляр: маляром
март: марта
мастер: мастер мастером
мастерская: мастерской
материал: материал
мать: мать
место: место
михаил: михаил михаила
михая: михаи
мобильный: мобильная
монументальный: монументальной
мордвинов: мордвиновым
мороз: мороз
москва: москва москве
мосха: мосха
мочь: могут
музей: музее музей музея
мы: нами
мыльников: мыльникова
н: н
навигация: навигации навигация
народный: народного народным
натюрморт: натюрморт натюрморта
научный: научный
национальный: национальной
нгельский: нгельский
неизданный: неизданных
некоммерческий: некоммерческой
некорректный: некорректный
неопр: неопр
несколько: несколько
нович: нович
новый: новые
ноябрь: ноября
образ: образ
обращение: обращения
обсуждение: обсуждение
огонь: огонь
окончить: окончил
октябрь: октябрь октября
описание: описание
организация: организации
оригинал: оригинала
ослепительный: ослепительным
ответственность: ответственности
отдельный: отдельных
отец: отец
отказ: отказ
открытие: открытие
ошибка: ошибке
пейзаж: пейзаж пейзажа пейзажах
первый: первая первой
перейти: перейти
персоналия: персоналии
персональный: персональная персональной персональные
печать: печати печать
писать: писал
пловдив: пловдив
поведение: поведения
подробный: подробнее
поездка: поездку
пожертвовать: пожертвовать
поиск: поиск поиску
покорение: покорение
политика: политика
получить: получить
портрет: портреты
портретный: портретная
последний: последние
поступить: поступил
править: править
правка: правки
право: правами
представительство: представительстве
представить: представлены
представиться: представились
приглашение: приглашению
примечание: примечания
природа: природу
проверяться: проверялась
провинция: провинции
проект: проектах
прожить: прожил
произведение: произведений
просмотр: просмотры
пространство: пространства
работа: работ работы
работать: работал
рабочий: рабочим
разработчик: разработчики
разряд: разряда
расширение: расширение
репин: репина
репрод: репрод
республиканский: республиканские
рисунок: рисунка
родиться: род родившиеся родился
рождение: рождения
роспись: росписью
российский: российский российском российскую
россия: россии россия
рсфср: рсфср
рубеж: рубежом
руновый: рунов
русский: русский русском
русый: рус
сад: сады
санитарка: санитаркой
сантал: сантал
сведение: сведения
свежий: свежие свежий
свет: свет светом
светоносный: светоносный
свободный: свободной
связанный: связанные
связаться: свяжитесь
север: север
семья: семьи
симфония: симфония
система: системе
сияние: сияние
скачать: скачать
скрытый: скрытые
скульптура: скульптуры
славянск: славянск
служба: службы
служебный: служебные
слуцкий: слуцкий
случай: случаю случаях
случайный: случайная
смерть: смерти
смотреть: см
собранный: собран
событие: события
совершить: совершил
современный: современной
содержание: содержание
создать: создать
созополь: созополь
соколинский: соколинская
сон: сны
сообщество: сообщество
сообщить: сообщить
соответствующий: соответствующими
состояться: состоялась
сотрудник: сотрудник
сохранение: сохранением
сочи: сочи
сочинский: сочинском
союз: союза
справка: справка
ссср: ссср
ссылка: ссылки
старший: старший
статистика: статистика
стать: стал
статья: статьи статья
степанов: степановых
стиль: стиле стиль
стих: стихи
стихотворение: стихотворений
страна: страна страны
страница: страница странице страницы
стрижов: стрижова
стройка: стройках
сюда: сюда
тайна: тайна
так: т
также: также
татьяна: татьяна
творческий: творческих
творчество: творчество
текст: текст
текущий: текущие
тимашевский: тимашевском
товарный: товарный
токарь: токарем
трошкова: трошкова
уехать: уехал
указание: указанием
умереть: умер
умерший: умершие
унести: унесенные
условие: условий условия
участие: участие
участник: участниками участником
учебный: учебных
училище: училища училище
учёба: учёба
учётный: учётную
ф: ф
факультет: факультете
фамилия: фамилией
фонд: фонд
форум: форум
франция: франции
х: х
художественный: художественная художественного художественное художественном художественный
художник: художник художника художнике художники художников художником
цвет: цвет
цветной: цветной цветные
цветущий: цветущие
цдх: цдх
центральный: центральный
чарлза: чарлза
частный: частных
часть: часть
человек: людях человек
чистый: чистое
читать: читать
член: член члены
шесть: шесть
экспорт: экспорт
элемент: элемент
энциклопедия: энциклопедии
юбилей: юбилея
южный: южно
язык: языках
