аветович: аветович
авторство: авторства
академический: академического
академия: академии академия
алфавит: алфавиту
армения: армении
армянский: армянский армянского армянской армянском
арутчян: арутчян
архивировать: архивировано
балет: балета
бек: бек
биография: биография
большой: большой
вднх: вднх
век: века
версия: версия
верховный: верховного
викидать: викиданных
викимедиа: викимедиа
википедия: википедии википедия
вклад: вклад
войти: войти
выдающийся: выдающиеся
высокий: высшей
георгий: георгия
главный: главным
год: года году
гражданство: гражданство
график: график
графика: графики
гроза: гроза
губерния: губерния
давид: давид
дата: дата
действовать: действовать
декорационный: декорационного
декорация: декорации
дело: деле
депутат: депутаты
деятельность: деятельности
дополнительный: дополнительные
доступный: доступен
другой: других
елизаветпольский: елизаветпольская
ереван: ереван
ещё: ещё
женитьба: женитьба
жить: жил
заглавный: заглавная
занятие: занятий
запись: запись
зарегистрировать: зарегистрированный
заслуга: заслуги
заявление: заявление
звание: звания
знак: знак
знамя: знамени
избранный: избранные
изображение: изображений
иллюстрация: иллюстрации
империя: империя
имя: имени имя имён
инструмент: инструменты
искусство: искусства
использование: использования
история: история
источник: источник
июль: июля
июнь: июня
кавалер: кавалеры
карикатура: карикатуры
категория: категории
кино: кино
кладбище: кладбище
книжный: книжной
код: код
кодекс: кодекс
коларосся: коларосси
конфиденциальность: конфиденциальности
коренной: коренным
короткий: короткий
который: которых
кпсс: кпсс
красный: красного
кук: куки
культура: культуру
л: л
лицензия: лицензии
м: м
мастерская: мастерской
материал: материал
место: место
микаел: микаел
михаил: михаил
мобильный: мобильная
мокульский: мокульского
москва: москва москве
мочь: могут
музыкальный: музыкального
мы: нами
мятеж: мятеж
навигация: навигации навигация
награда: награды
наградить: награждён
направление: направлений
народный: народные народный
некоммерческий: некоммерческой
новаторский: новаторских
новый: новые
нська: нська
область: области
образ: образом
обсуждение: обсуждение
обучаться: обучавшиеся
одновременно: одновременно
опера: оперы
описание: описание
организация: организации
орден: ордена орденом
оригинал: оригиналом
основоположник: основоположников
ответственность: ответственности
отдельный: отдельных
отелло: отелло
отказ: отказ
отредактировать: отредактирована
оформить: оформил
ошибка: ошибке
павильон: павильона
парижский: парижской
пепо: пепо
переехать: переехал
перейти: перейти
персоналия: персоналии
персональный: персональные
печать: печати печать
плакат: плаката
поведение: поведения
подробный: подробнее
пожертвовать: пожертвовать
поиск: поиск поиску
политика: политика
получить: получить
последний: последний
постановщик: постановщиком
постоянный: постоянная
похоронить: похороненные
похоронный: похоронен
править: править
правка: правки
представиться: представились
преобразовать: преобразовал
примечание: примечания
продолжатель: продолжателем
проект: проектах
просмотр: просмотры
пространство: пространства
пуш: пуш
работать: работал
развитие: развития
разработчик: разработчики
ред: ред
родиться: род родившиеся родился
рождение: рождении рождения
российский: российская
русский: русский
саратовский: саратовской
сведение: сведения
свежий: свежие
свободный: свободной
связанный: связанные
связаться: свяжитесь
система: системе
скачать: скачать
скрытый: скрытые
служебный: служебные
случай: случаях
случайный: случайная
смерть: смерти
смотреть: см
событие: события
совет: совета
советский: советская советский
содержание: содержание
создание: создании
создать: создать
сообщество: сообщество
сообщить: сообщить
сохранение: сохранением
спектакль: спектаклей
спендиаров: спендиарова
справка: справка
среди: среди
сср: сср
ссср: ссср
ссылка: ссылка ссылки
станковый: станковой
статистика: статистика
статья: статьи статья
сто: ста
страница: страница странице страницу страницы
сундукян: сундукяна
сцена: сцены
сценограф: сценограф
сюда: сюда
так: т
также: также
театр: театр театра
театрально: театрально
театральный: театральная театрального театральные
текст: текст
текущий: текущие
технический: технической
тип: тип
товарный: товарный
трудовой: трудового
указание: указанием
укра: укра
умерший: умершие
условие: условий условия
участвовать: участвовал
участие: участие
учиться: учился
учёба: учёба
учётный: учётную
фигаро: фигаро
фильм: фильмов
фонд: фонд
форум: форум
халатян: халатян
хас: хас
художественно: художественно
художество: художеств
художник: художник художники художником
цитировать: цитировать
человек: человек
читать: читать
член: член члены
шаблон: шаблона
шуша: шуша шуше
экспорт: экспорт
элемент: элемент
энциклопедия: энциклопедии энциклопедия
этот: эта
являться: являлся
язык: языках
якулов: якулова
