абай: абаев абай
август: августа
авторство: авторства
агысый: агыс
аз: аза
алма: алма
алматинский: алматинского алматинской
алфавит: алфавиту
архивировать: архивировано
асен: асен
атинский: атинское
ашкинази: ашкинази
барыс: барыс
баянаул: баянаул баянауле
биография: биографии биография
ведущий: ведущих
век: века
версия: версии версия
викидать: викиданных
викимедиа: викимедиа
википедия: википедии википедия
вклад: вклад
включить: включённым
войти: войти
вручить: вручил
выдающийся: выдающиеся
выпускник: выпускники
год: года году
государственный: государственной государственные
график: график
графика: графики
гёте: гёте
дата: дата
действовать: действовать
декабрь: декабря
декоративный: декоративно
детский: детской
деятель: деятели деятель деятелям
дополнительный: дополнительные
доступный: доступен
другой: других
единство: единства
ещё: ещё
жазуш: жазушы
жазуша: жазуши
жанр: жанр
живописец: живописец
заглавный: заглавная
занятие: занятий
запись: запись
зарегистрировать: зарегистрированный
заслуга: заслуги
заслужить: заслуженные заслуженный
заявление: заявление
звание: звания
знак: знак
избранный: избранные
известный: известен
издание: издание издания
издательство: издательств издательства
изменение: изменения
изображение: изображений
изобразительный: изобразительного
иллюстратор: иллюстраторы
имя: именем имён
институт: институт
инструмент: инструменты
информация: информации
искусство: искусств искусства
искусствовед: искусствовед
использование: использования
использоваться: использовался
история: история
источник: источник
кавалер: кавалеры
каз: каз
казахский: казахская казахский казахской
казахстан: казахстан казахстана казахстане
касен: касен
категория: категории
книга: книга книги
книжный: книжных
код: код
кодекс: кодекс
колледж: колледжа
комиссия: комиссии
компания: компании
конфиденциальность: конфиденциальности
короткий: короткий
кук: куки
кул: кул
культура: культуры
лауреат: лауреат лауреаты
литература: литература
лицензия: лицензии
лхан: лхан
лы: лы
март: марта
мастер: мастеров
материал: материал
международный: международного
место: место
министр: министр
мобильный: мобильная
монумент: монументам
московский: московский московского
мочь: могут
мухаммед: мухаммед
мухтар: мухтар
мы: нами
навигация: навигации навигация
награда: награды
наградить: награждён
написание: написании
наука: науки
национальный: национальная
некоммерческий: некоммерческой
неопр: неопр
новый: новые
область: области область
обращение: обращения
обсуждение: обсуждение
ожидать: ожидают
окончить: окончил
описание: описание
организация: организации
орден: ордена орденом
оркестр: оркестр
ответственность: ответственности
отдельный: отдельных
отказ: отказ
отредактировать: отредактирована
ошибка: ошибке
павлодарский: павлодарская павлодарской
памятник: памятникам
парасат: парасат
перейти: перейти
персоналия: персоналии
персональный: персональные
петербург: петербург
печать: печати печать
поведение: поведения
подробный: подробнее
пожертвовать: пожертвовать
поиск: поиск поиску
поколение: поколений
полиграфический: полиграфический
политика: политика
получить: получить
последний: последний
постоянный: постоянная
править: править
правка: правки
правление: правления
предоставить: предоставленного
председатель: председатель
представиться: представились
преемственность: преемственности
президент: президент президента
премия: премии
прикладной: прикладного
примечание: примечания
проведение: проведению
проверить: проверена
проверка: проверки
проект: проектах
просмотр: просмотры
пространство: пространства
работать: работал
разработчик: разработчики
редактор: редактор редактором
редакция: редакцией
республика: республике республики
республиканский: республиканских
родиться: род родившиеся родился
рождение: рождения
руководитель: руководитель
русский: русский русском
санкт: санкт
сведение: сведения
свежий: свежие
свободный: свободной
связанный: связанные
связаться: свяжитесь
сеилханович: сеилханович
сей: сей
секретарь: секретарь
село: селе
сентябрь: сентября
система: системе
скачать: скачать
скрытый: скрытые
скульптор: скульптор скульпторы
служебный: служебные
случай: случаях
случайный: случайная
смотреть: см
событие: события
советский: советский
современник: современников
содержание: содержание
создать: создать
сообщество: сообщество
сообщить: сообщить
сооружать: сооружаемым
состав: состав
сохранение: сохранением
союз: союза
спб: спб
справка: справка
сср: сср
ссср: ссср
ссылка: ссылка ссылки
стабильный: стабильная
статистика: статистика
статья: статьи статья
степень: степени
стр: стр
страна: страна
страница: страница странице страницу страницы
сюда: сюда
так: т
текст: текст текстом
текущий: текущая текущие
тип: тип
товарный: товарный
указ: указом
указание: указанием
университет: университета
условие: условий условия
участие: участие
училище: училище
учёба: учёба
учётный: учётную
фамилия: фамилией
фонд: фонд фонда
форум: форум
х: х
хасен: хасен
художественный: художественного художественное художественный художественным
художник: художник художники художников
цитировать: цитировать
человек: людях человек
чистобаев: чистобаев
читать: читать
член: член члены
ша: ша
шаблон: шаблонов
экспорт: экспорт
элемент: элемент
энциклопедия: энциклопедии энциклопедия
энциклопедияс: энциклопедиясы
этот: эта
язык: языках
