абба: аббе
абзгильдина: абзгильдин
абрек: абрек
авт: авт
автор: авторы
авторство: авторства
автоцинкография: автоцинкография
адыл: адылов
академик: академик
академия: академии
александр: александр
алфавит: алфавиту
альберт: альберт
альмеев: альмеев
альфиза: альфиз
альфий: альфия
анатолий: анатолий
англ: англ
антонов: антонова
апрель: апреля
арт: арт
артамон: артамонов
архивировать: архивировано
архивный: архивная
архитектурный: архитектурный
аршинов: аршинов
асий: асия
ахмет: ахметов
ахметов: ахметова
б: б
бак: баки
башмак: башмаков
бердников: бердников
библиография: библиография
библиотека: библиотека
биеннале: биеннале
бикташев: бикташева
биктемиров: биктемирова
биография: биографии биография
благодат: благодатов
боровский: боровский
бронзовый: бронзовой
букварь: букварь
булат: булат
быть: е
валеев: валеева
ван: ван
васильев: васильева
век: вв века
вера: вера
версия: версия
викидать: викиданных
викимедиа: викимедиа
викиновость: викиновости
википедия: википедии википедия
викисклад: викисклад викискладе
виктор: виктор
вклад: вклад
внешний: внешние
войти: войти
волгоград: волгоград
волгоградский: волгоградский
волшебный: волшебные
время: время
всадник: всадник
вст: вст
выборочно: выборочно
выпускник: выпускники
выставка: выставка выставки выставок
г: г
габбас: габбасов
газеев: газеев
гайнутдин: гайнутдинов
галерея: галерее галерея
гильван: гильванов
гимаев: гимаев
гмии: гмии
год: года году лет
город: город городам
городской: городской
горюнов: горюнова
государственный: государственный
гравюра: гравюры
град: град
гражданство: гражданство
график: график
графика: графики
графический: графической
графкома: графком
григорий: григорий
григорьянц: григорьянц
групповой: групповой групповых
гумилёв: гумилёв
далее: д
дата: дата
действовать: действовать
декабрь: декабря
державин: державина
деятель: деятели деятель
деятельность: деятельности
диляр: диляра
дин: дина
динар: динар
добавить: добавить
дополнительный: дополнительные
достижение: достижения
достойный: достойному
доступный: доступен
другой: других
егоров: егоров
елена: елена
ермолин: ермолина
ещё: ещё
жанр: жанр жанре
живописец: живописец
жить: живет
загидуллин: загидуллин
заглавный: заглавная
заман: заман
занятие: занятий
запись: запись
зарегистрировать: зарегистрированный
зарип: зарипов
заслужить: заслуженные заслуженный
заявление: заявление
земфира: земфира
зифа: зифа
знак: знак знаком
золотой: золотой
зуфар: зуфар
игорь: игорь
избранный: избранные
изд: изд
изображение: изображений
изобразительный: изобразительного изобразительных
ил: ил
ильдар: ильдар
ильдус: ильдус
ильясова: ильясова
имя: имени имён
инструмент: инструменты
ирина: ирина
искусство: искусств искусства
использование: использования
использовать: использующие
историко: историко
история: истории история
источник: источник
июнь: июня
казанский: казанская казанский казанского казанское
казань: казани казань
казачинский: казачинский казачинском
камалетдинов: камалетдинова
канафий: канафия
карасёвый: карасёва
караульщик: караульщик
картинный: картинная
каталог: каталог
категория: категории
каширка: каширке
климов: климова
км: км
книга: книг книги
код: код
кодекс: кодекс
коллекция: коллекцию коллекция
колмогорцев: колмогорцева
конокотина: конокотина конокотиной
конфиденциальность: конфиденциальности
копия: копия
короткий: короткий
корреспондент: корреспондент
край: край края
красноярский: красноярский
кремль: кремль
кузьмин: кузьминых
кук: куки
культура: культуре культуру
культурный: культурный
кумысников: кумысникова
л: л
лаборатория: лаборатории
лаишевский: лаишевского
лан: лана ланы
лауреат: лауреат лауреаты
лемменс: лемменс
лилия: лилия
линогравюра: линогравюра
лицензия: лицензии
луиза: луиза
любовь: любви
мадияр: мадияр
мардан: марданов
марков: марков маркова
мастерская: мастерских
материал: материал
машков: машкова
медаль: медалью медалями
медиафайл: медиафайлы
международный: международная
место: место
минулин: минулина
михаилович: михайлович
мк: мк
множество: множества
мобильный: мобильная
москва: москва
мочь: могут
мск: мск
музей: музей музея
музейный: музейные
мухаметдин: мухаметдинов
мухаметзянов: мухаметзянова
мы: нами
н: н
набережночелнинский: набережночелнинская
набережный: набережные
навигация: навигации навигация
наврозовый: наврозова
награда: награды
наградить: награжден награждённые
надир: надир
наиля: наиля
настоящий: настояще
науфаля: науфаль
научный: научная
нафик: нафиков
национальный: национальный
нвз: нвз
некоммерческий: некоммерческой
ненависть: ненависти
неопр: неопр
нидерланды: нидерланды
низамутдин: низамутдинов
нина: нина
нияз: нияз
новицкий: новицкий
новый: новые
ноябрь: ноября
нтв: нтв
нургалеев: нургалеева
обращение: обращения
обсуждение: обсуждение
окончить: окончил
ольга: ольга
описание: описание
организатор: организатор организаторов
организация: организации
остров: остров
ответственность: ответственности
отдел: отдел
отделение: отделение отделении
отдельный: отдельных
отечественный: отечественную
отказ: отказ
отредактировать: отредактирована
офорт: офорт
ошибка: ошибке
павел: павел
парыгин: парыгин
передать: передан
перейти: перейти
персоналия: персоналии
персональный: персональные
петербург: петербург петербурге
петров: петров
печатный: печатной
печать: печати печать
пискуновка: пискуновка
поведение: поведения
поволжский: поволжском
подробный: подробнее
пожертвовать: пожертвовать
поиск: поиск поиску
политика: политика
получить: получить
последний: последний
постоянный: постоянная
почётный: почетный почетным
править: править
правка: правки
представиться: представились
премия: премии
примечание: примечания
приобретение: приобретение
проект: проект проекта проектах проектов
просмотр: просмотры
пространство: пространства
пустой: пуст
пушкин: пушкина
р: р
рабис: рабис
работать: работает
равиль: равиль
разработчик: разработчики
район: район районе
рассказать: рассказали
рауза: рауза
рах: рах
рашит: рашит
редкий: редких
ренат: ренат
репортаж: репортаж
республика: республики
ринат: ринат
рият: рият
родиться: род родившиеся
рождение: рождения
розалина: розалина
российский: российские российских российской
россия: россии россия
рсфср: рсфср
руководитель: руководителем руководитель
рукопись: рукописей
русский: русский русского русской
рустам: рустам
рустем: рустем
русый: рус
ряд: ряда
сабир: сабиров
сагида: сагида
сайт: сайт
салимов: салимов
салях: саляхов
санкт: санкт
саттаров: саттарова
сведение: сведения
свежий: свежие
свияжск: свияжск
свободный: свободной
связанный: связанные
связаться: свяжитесь
северюхин: северюхин
сегодня: сегодня
сектор: сектор
секция: секции
сентябрь: сентября
серебряный: серебряной
серж: серж
сиразиев: сиразиева
система: системе
скачать: скачать
скрытый: скрытые
скульптура: скульптуры
служебный: служебные
случай: случаях
случайный: случайная
смотреть: см
собрание: собрания
событие: события
современник: современников
современный: современные
содержание: содержание
создать: создать
сообщество: сообщество
сообщить: сообщить
состав: составе
софия: софия
сохранение: сохранением
союз: союза
спб: спб
справка: справка
ссср: ссср
ссылка: ссылка ссылки
ст: ст
статистика: статистика
стать: статей
статья: статьи статья
стоммелс: стоммелс
страница: страница странице страницу страницы
странник: странник
субъективность: субъективность
султанов: султанова
суюр: суюров
сюда: сюда
так: т
тат: тат
татарстан: татарстан татарстана татарстане
творческий: творческих творческого
театральный: театрального театральное
текст: текст
текущий: текущие
тип: тип
товарный: товарный
триеннале: триеннале
указание: указанием
указать: указан
улемновый: улемнова
урманча: урманче
условие: условий условия
участие: участие
участник: участник
училище: училища училище
учёба: учёба
учётный: учётную
фамилия: фамилией
фарид: фарид фарида
фасхутдинов: фасхутдинова
февраль: февраля
фейсбук: фейсбуке
фешина: фешина
фонд: фонд
формат: формате
форум: форум
х: х
хазиахмет: хазиахметов
хазиев: хазиев
халит: халитов
халитовый: халитова
хасанович: хасановича
хасьяновый: хасьянова
художественный: художественное художественный
художество: художеств
художник: художник художника художники художников
хх: хх
цв: цв
ценный: ценное
центр: центр
цитировать: цитировать
челны: челны
человек: людях человек
читать: читать
шаблон: шаблон
шагеев: шагеева
шамсут: шамсутов
шаукат: шауката
эйдин: эйдинов
эйндховен: эйндховен
экспериментальный: экспериментальных
экспорт: экспорт
элемент: элемент
энциклопедия: энциклопедии
эрмитаж: эрмитаж
эстампист: эстампист
этот: эта
являться: является
яз: яз
язык: язык языках
январь: января
