абстрагированный: абстрагированно
абстракционизм: абстракционизм
абстракционист: абстракционисты
август: августа
авторство: авторства
академия: академии
алфавит: алфавиту
англ: англ
английский: английский
армитидж: армитидж
архаический: архаического
архивировать: архивировано
архивный: архивная
библиографический: библиографических
биеннале: биеннале
биографический: биографический
больший: большая
британский: британский британской
бронзовый: бронзового
брюссель: брюсселя
вд: вд
век: века
великобритания: великобритании великобритания
венецианский: венецианском
венеция: венеции
версия: версия
викидать: викиданных
викимедиа: викимедиа
википедия: википедии википедия
викисклад: викисклад викискладе
вклад: вклад
внешний: внешние
война: войны
войти: войти
волшебный: волшебные
вручать: вручает
выигрывать: выигрывает
выпускник: выпускники
выставка: выставке выставки
генри: генри
геометрия: геометрия
год: года годах году лет
гражданство: гражданство
дата: дата
датский: датская
действовать: действовать
деятельность: деятельности
дополнительный: дополнительные
доступный: доступен
др: др
древнегреческий: древнегреческого
древнеегипетский: древнеегипетского
другой: других
ещё: ещё
жанр: жанр
жертва: жертвам
живопись: живопись
жизнь: жизнь
заглавный: заглавная
запись: запись
зарегистрировать: зарегистрированный
затем: затем
заявление: заявление
знак: знак
избранный: избранные
изображать: изображал
изучать: изучает
изящный: изящных
империя: империи
имя: имён
инструмент: инструменты
искусство: искусств искусства
использование: использования
использовать: использующие
история: история
источник: источник источниками
июль: июля
йоркский: йоркском
йоркшир: йоркшира
кассель: касселе
каталанский: каталанская
каталог: каталогах
категория: категории
кеннет: кеннет
кикладский: кикладского
код: код
кодекс: кодекс
колледж: колледже
командор: командоры
конкурс: конкурс
конфиденциальность: конфиденциальности
копия: копия
королева: королева
королевский: королевской
короткий: короткий
крефелёд: крефельде
крупный: крупнейших
кук: куки
кёльн: кёльна
лидс: лидс лидсе
лидский: лидского
литература: литература
литовский: литовская
литограф: литограф
литьё: литья
лицензия: лицензии
лондон: лондон лондоне
м: м
май: мая
мастер: мастер
материал: материал
медиафайл: медиафайлы
место: место
мир: мира
мобильный: мобильная
молодой: молодой
мочь: могут
музей: музее музеях
мур: мура
мы: нами
навигация: навигации навигация
награда: награды
направление: направления
начальный: начальный
некоммерческий: некоммерческой
немецкий: немецком
нидерл: нидерл
новый: новые
норвежский: норвежская
нью: нью
обращение: обращения
обсуждение: обсуждение
оксфордский: оксфордский
описание: описание
организация: организации
орден: орден ордена
ответственность: ответственности
отдельный: отдельных
отказ: отказ
отмечаться: отмечается
отредактировать: отредактирована
ошибка: ошибке
памятник: памятника
париж: парижа
парижский: парижском
парка: парке
перейти: перейти
период: период
персоналия: персоналии
персональный: персональные
печать: печати печать
поведение: поведения
подпись: подписи
подражать: подражает
подробный: подробнее
пожертвовать: пожертвовать
поиск: поиск поиску
политика: политика
получить: получить
послевоенный: послевоенного
последний: последний
постоянный: постоянная
править: править
правка: правки
представиться: представились
преимущественно: преимущественно
примечание: примечания
проект: проектах
произведение: произведениям
просмотр: просмотры
пространство: пространства
проходить: проходят
работа: работ работы
разработчик: разработчики
ресурс: ресурсы
родиться: род родившиеся
рождение: рождения
роттердам: роттердама
русский: русский русской
сайт: сайты
сведение: сведения
свежий: свежие
свободный: свободной
свой: свой
связанный: связанные
связаться: свяжитесь
сентябрь: сентября
система: системе
скачать: скачать
скрытый: скрытые
скульптор: скульптор скульпторы
скульптура: скульптура скульптуру
скульптурный: скульптурного
слейда: слейда
словарь: словари
служебный: служебные
случай: случаях
случайный: случайная
смерть: смерти
смотреть: см
событие: события
современный: современного современные
содержание: содержание
создание: создание
создатель: создателей
создать: создать
сообщество: сообщество
сообщить: сообщить
соответственно: соответственно
сохранение: сохранением
справка: справка
ссылка: ссылка ссылками ссылки
становиться: становится
статистика: статистика
статья: статьи статья
страница: страница странице страницу страницы
страх: страха
сюда: сюда
также: также
творчество: творчества творчество
тейт: тейт
текст: текст
текущий: текущие
тематический: тематические
ти: ти
товарный: товарный
увидеть: увидеть
уильям: уильям
указание: указанием
умерший: умершие
универсальный: универсальная
университет: университета
условие: условий условия
участвовать: участвует
участие: участие
учёба: учёба
учётный: учётную
фамилия: фамилией
феликс: феликса
фигура: фигуры
фонд: фонд
форум: форум
хорватский: хорватская
хороший: лучший
художественный: художественных
художник: художники
цитировать: цитировать
цюрих: цюриха
человек: людях
человеческий: человеческие
читать: читать
член: членом
школа: школа школе школы
экспорт: экспорт
элемент: элемент элементы
энциклопедия: энциклопедии
эрмитидж: эрмитидж эрмитиджа эрмитиджу
этот: эта
язык: языках
январь: января
