автор: автор
авторство: авторства
агитационный: агитационно
александр: александр
александров: александров
алфавит: алфавиту
андрейкать: андрейкан
антолог: антолог
армия: армии
архивировать: архивировано
ассоциация: ассоциации
б: б
бажан: бажан бажана
биобиблиографический: биобиблиографический
биография: биография
бл: бл
бой: бой
быть: е
ванович: ванович
век: века
вернадський: вернадського
версия: версия
взятие: взятие
видавничий: видавничий
викидать: викиданных
викимедиа: викимедиа
википедия: википедии википедия
виртуальный: виртуальный
вклад: вклад
внешний: внешние
военный: военно
война: войны
войти: войти
волшебный: волшебные
вольценбург: вольценбург
время: время
выпускник: выпускники
выставка: выставке выставки
гадина: гадину
гайдамак: гайдамаки
героический: героический
глава: главе
гоголь: гоголь гоголя
год: год года годах году лет
головен: головна
город: город
государственный: государственного
гражданский: гражданской
график: график
графика: графики
губерния: губерния
гуцул: гуцулы
далее: д
данные: данным
дата: дата
действовать: действовать
декабрь: декабря
декоративный: декоративной
деятель: деятели
деятельность: деятельности
дникнуть: дник
дов: дов
довбуш: довбуш
донбасс: донбасс
дополнительный: дополнительные
доступный: доступен
другой: другим других
енциклопед: енциклопед
енциклопедичние: енциклопедичний
ещё: ещё
живописец: живописец
живописный: живописных
живопись: живопись живописью
заглавный: заглавная
заниматься: занимался
занятие: занятий
запись: запись
зарегистрировать: зарегистрированный
застава: заставе
заявление: заявление
знак: знак
иванович: иванович
избранный: избранные
известный: известные
издательство: издательствах издательство
изображение: изображений
изобразительный: изобразительного
иллюстратор: иллюстратор иллюстраторы
империя: империя
имя: имя имён
инструмент: инструменты
искусство: искусств искусства искусство искусством
исполнять: исполнял
использование: использования
использовать: использующие
история: история
источник: источник
июль: июля
карпаты: карпатах
картина: картин картины
категория: категории
ки: ки
киев: киев киева киеве
книга: книг книги
книжный: книжной
кобылянский: кобылянская
код: код
кодекс: кодекс
комсомол: комсомол
конфиденциальность: конфиденциальности
короткий: короткий
коса: кос
красный: красной красные
крестьянин: крестьян
крещение: крещение
крыло: крылья
кудрицький: кудрицький
кук: куки
л: л
лавр: лавры
лев: львов
ледовый: ледовое
ленинский: ленинский
лермонтов: лермонтова
литература: литература
литограф: литографы
литографический: литографические
лицензия: лицензии
ломоносов: ломоносов
любимов: любимова
м: м
манёвр: манёвры
масса: массам
массовый: массовым
материал: материал
мена: мен
место: место
мировой: мировой
митц: митц
михаил: михаил
мобилизация: мобилизации
мобильный: мобильная
могила: могила
молодой: молодым
морской: морского
москва: москва
мочь: могут
мощный: мощные
музей: музей
мы: нами
н: н
навигация: навигации навигация
народ: народов
настоящий: настоящая
находиться: находился
нац: нац
начало: начало
наш: наша нашей
некоммерческий: некоммерческой
неопр: неопр
николай: николай
новый: новые
ночной: ночные
нська: нська
нський: нського
нсько: нсько
оборона: обороне
обращение: обращения
обсуждение: обсуждение
ограф: ограф
окрылять: окрыляйте
октябрь: октября
олександр: олександр
ольга: ольга
ональна: ональна
описание: описание
организация: организации
осенний: осенней
оставаться: остаётся
ответственность: ответственности
отдельный: отдельных
отказ: отказ
отредактировать: отредактирована
отряд: отряд
отёк: отека
оформитель: оформитель
оформлять: оформлял
ошибка: ошибке
п: п
партизан: партизаны
партизанский: партизанский
пейзаж: пейзажи
первый: первой первый
перейти: перейти
переяславский: переяславская
персоналия: персоналии
персональный: персональные
першо: першо
печать: печати печать
писать: писал
плакат: плаката плакаты
плакатист: плакатист плакатисты
побоище: побоище
поведение: поведения
подробный: подробнее
пожертвовать: пожертвовать
поиск: поиск поиску
политика: политика
полотно: полотен
получить: получить
портрет: портреты
портретист: портретисты
последний: последний
постановка: постановки
постоянный: постоянная
постышев: постышевым
править: править
правка: правки
представиться: представились
примечание: примечания
проект: проектах
произведение: произведений
просмотр: просмотры
пространство: пространства
псевдоним: псевдонимами
пушкин: пушкин
пётр: пётр
работа: работы
работать: работал
рада: рада
радянсько: радянсько
раенко: раенко
раздавить: раздавим
различный: различных
разработчик: разработчики
ре: ре
революция: революции
редакца: редакц
резерв: резервом
ресурс: ресурсы
ркк: ркка
родиться: род родившиеся родился
рождение: рождении рождения
российский: российская
россия: россии россия
рукопись: рукописи
русский: русский
русь: руси
ряд: рядах
сведение: сведения
свежий: свежие
свободный: свободной
связанный: связанные
связаться: свяжитесь
севастополь: севастополе
селезень: селезень
сентябрь: сентября
серия: серия
сжигать: сжигает
сибирский: сибирские
сила: сила
система: системе
скачать: скачать
скрытый: скрытые
словарь: словари словарь
словник: словник словника
служебный: служебные
случай: случаях
случайный: случайная
смерть: смерти
смотреть: см
событие: события
советский: советский
современный: современной
содержание: содержание
создать: создать
соловей: соловьёв
сообщество: сообщество
сообщить: сообщить
сохранение: сохранением
соцреализм: соцреализм
справка: справка
среди: среди
ссср: ссср
ссылка: ссылка ссылки
сталин: сталин
станковый: станковая станковой
старый: старый
статистика: статистика
статья: статьи статья
стиль: стиль
стол: стол
стр: стр
страна: страна
страница: страница странице страницу страницы
сюда: сюда
так: т
тачанка: тачанка
ташкент: ташкент
театральный: театральные
текст: текст
текущий: текущие
тематический: тематических
тип: тип
товарищ: товарищем
товарный: товарный
трамвай: трамвай
третиня: третини
ття: ття
тунгусский: тунгусский
указание: указанием
укра: укра
украина: украину украины
украинский: украинских украинской
умереть: умер
умерший: умершие
условие: условий условия
усср: усср
участвовать: участвовал
участие: участие
участник: участник участники
училище: училища училище
учиться: учился
учёба: учёба
учётный: учётную
фамилия: фамилией фамилия
фашистский: фашистскую
февраль: февраля
федькович: федькович
физкультура: физкультура
филиал: филиал
флот: флота
фонд: фонд
форум: форум
х: х
харьков: харьков харькова харькове
харьковский: харьковская харьковского харьковское харьковской харьковском
художественный: художественного художественное художественной художественном
художник: художник художники художников
хх: хх
цитировать: цитировать
ч: ч
человек: людях человек
читать: читать
член: членом члены
чный: чного
школа: школе
щорс: щорса
э: э
экспорт: экспорт
элемент: элемент
энциклопедический: энциклопедический
энциклопедия: энциклопедии
этот: эта
ю: ю
юбилейный: юбилейной
юрий: юрий
являться: являлся
язык: языках
