август: августа
авторство: авторства
академия: академии
алфавит: алфавиту
алха: алха
алхаз: алхазов
ао: ао
армия: армии
архивировать: архивировано
асср: асср
биография: биографии биография
бойцов: бойцова
век: века
великий: великой
версия: версия
викидать: викиданных
викимедиа: викимедиа
википедия: википедии википедия
вклад: вклад
война: войне
войти: войти
волгоград: волгоград
вологда: вологда
волшебный: волшебные
всероссийский: всероссийская всероссийских
выпускник: выпускники
выставка: выставка выставках выставки выставок
глава: главы
год: год года году лет
городской: городских
государственный: государственного государственной государственный
гражданство: гражданство
графический: графического графическое
грозненский: грозненский
грозный: грозного грозном грозный
гудермесский: гудермесский гудермесского
дания: дания
дата: дата
действовать: действовать
декоративный: декоративных
день: дня
детский: детских детской
деятельность: деятельности деятельность
диплом: дипломом
директор: директором
дополнительный: дополнительные
доступный: доступен
другой: других
дума: думе
душа: души
ещё: ещё
живописец: живописец
живописный: живописных
живопись: живописи
заглавный: заглавная
запись: запись
заполнить: заполнить
зарегистрировать: зарегистрированный
зарубежный: зарубежных
заслужить: заслуженные заслуженный
заявление: заявление
звание: звание звания
знак: знак
зов: зов
зональный: зональная зональных
зязикова: зязикова
ивановский: ивановский ивановском
избранный: избранные
издательско: издательско
изделие: изделиям
изображение: изображениями
изобразительный: изобразительного изобразительное
имя: имён
ингушетия: ингушетии ингушетия
ингушский: ингушская ингушской
институт: институт института
инструмент: инструменты
искусство: искусства искусство
использование: использования
использовать: использующие
история: история
источник: источник
ишха: ишхой
кавказ: кавказу
категория: категории
киев: киев
китай: китае
код: код
кодекс: кодекс
колорист: колорист
комплекс: комплекс
конкурс: конкурс
конфиденциальность: конфиденциальности
короткий: короткий
краснодар: краснодар
кук: куки
культура: культуры
летие: летию
лиссабон: лиссабон
литература: литература
лицензия: лицензии
м: м
март: марта
материал: материал
международный: международная международный международных
место: место
мир: мир
мобильный: мобильная
молодой: молодых
москва: москва
мочь: могут
мурат: мурата
мы: нами
н: н
навигация: навигации навигация
наградить: награждён
назначить: назначен
народный: народные народный
национальный: национальная
начать: начал
некоммерческий: некоммерческой
неоднократно: неоднократно
неопр: неопр
новый: новые
нохчийна: нохчийн
образ: образ
обращение: обращения
обсуждение: обсуждение
оденсе: оденсе
один: одной
окончить: окончил
октябрь: октября
описание: описание
организация: организации
ответственность: ответственности
отделение: отделение отделении отделения
отдельный: отдельных
отечественный: отечественной
отказ: отказ
отличие: отличием
отредактировать: отредактирована
ошибка: ошибке
париж: париже
педагогический: педагогический педагогического педагогическую
пединститут: пединститута
пейзаж: пейзажа
перейти: перейти
персоналия: персоналии
персональный: персональная персональные
печать: печати печать
победа: победы
побеждать: побеждали
поведение: поведения
пович: пович
подробный: подробнее
пожертвовать: пожертвовать
поиск: поиск поиску
полиграфический: полиграфический
политика: политика
получить: получить
португалия: португалия
посвятить: посвященная
последний: последний
постоянный: постоянная
править: править
правка: правки
представиться: представились
президент: президента
преподаватель: преподавателей
примечание: примечания
принять: принят
присвоить: присвоено
проводить: проводимых
проект: проектах
просмотр: просмотры
пространство: пространства
работа: работ
рабочий: рабочий
развитие: развитие
разработчик: разработчики
район: район района
рамка: рамках
расширение: расширение
реалистический: реалистической
региональный: региональных
республика: республике республики
республиканский: республиканская республиканских
ризва: ризва
ризван: ризван
рисование: рисования
родина: родины
родиться: род родившиеся родился
рождение: рождения
российский: российской
россия: россии россия
рсфср: рсфср
русский: русский
сведение: сведения
свежий: свежие
свободный: свободной
свойство: свойство
связанный: связанные
связаться: свяжитесь
село: селе
сентябрь: сентября
система: системе
скачать: скачать
скрытый: скрытые
служебный: служебные
служить: служил
случай: случаях
случайный: случайная
смотреть: см
событие: события
советский: советской
современник: современников
согреться: согревшиеся
содержание: содержание
создать: создать
сообщество: сообщество
сообщить: сообщить
сохранение: сохранением
сочи: сочи
союз: союза
специальность: специальности
справка: справка
средний: среднюю
ссср: ссср
ссылка: ссылка ссылки
статистика: статистика
статья: статьи статья
страница: страница странице страницу страницы
сюда: сюда
так: т
текст: текст
текстильный: текстильным
текущий: текущие
техникум: техникум техникуме
технологический: технологический технологическом
товарный: товарный
указ: указ указом
указание: указанием
университет: университета
условие: условий условия
участие: участие
участник: участник участником
учитель: учитель
учиться: учащиеся учился
учёба: учёба
учётный: учётную
фамилия: фамилией
февраль: февраля
федерация: федерации
фонд: фонд
форум: форум
хабаров: хабарова
химико: химико
художественно: художественно
художественный: художественного художественной художественном художественных
художество: художеств
художник: художник художники художников
цитировать: цитировать
человек: людях
черчение: черчения
чеченский: чеченский чеченских чеченского чеченской
чечня: чечни
чечь: чечено
читать: читать
член: член члены
школа: школ школу школы
экз: экз
экспорт: экспорт
элемент: элемент
энциклопедия: энциклопедии
этот: эта
юг: юг
юрта: юрт юрте
юртовсковать: юртовскую
юс: юсу
юсупович: юсупович
юфо: юфо
являться: является
язык: языках
