абдрахма: абдрахма
абдрахманович: абдрахманович
август: августа
автор: автору
авторство: авторства
академия: академии
акварель: акварелей
алишер: алишера
алфавит: алфавиту
альбом: альбом
ами: ами
амин: аминов
аминев: аминев
аминов: аминова
ан: ан
архивировать: архивировано
архитектура: архитектуры
асср: асср
баран: баран
баш: баш
башкирский: башкирскую
биография: биография
будущее: будущего
быть: е
вблизи: вблизи
век: века
великий: великой
версия: версии версия
викидать: викиданных
викимедиа: викимедиа
википедия: википедии википедия
вклад: вклад
водяной: водяная
война: войны
войти: войти
волшебный: волшебные
вступить: вступил
выполнить: выполнены
выпускник: выпускники
вырасти: выросли
высокий: высшем
выставка: выставках выставки
г: г
габдерахман: габдерахман
габдрахман: габдрахман
габдулла: габдуллы
героический: героическую
герой: героев
год: гг года годах годов году годы лет
город: городе
городской: городском
гражданство: гражданство
графика: графики
графический: графические
губерния: губернии губерния
дата: дата
действовать: действовать
декабрь: декабря
декоратор: декоратором
деятель: деятели деятель
деятельность: деятельности
джалиль: джалиль
диплом: диплом
дополнительный: дополнительные
достижение: достижения
доступный: доступен
драматический: драматические
другой: других
ещё: ещё
жанр: жанрах
жена: жена
живописец: живописец
живопись: живописи живопись
жизнь: жизни
жить: жил
заглавный: заглавная
запись: запись
зарегистрировать: зарегистрированный
зарубежный: зарубежных
заслужить: заслуженные заслуженный
затем: затем
заявление: заявление
звание: звания
зихнекамал: зихнекамал
знак: знак
значительно: значительно
зональный: зональных
избранный: избранные
известный: известный
изобразительный: изобразительных
иллюстратор: иллюстратор иллюстраторы
иллюстрация: иллюстрациях
илья: ильи
империя: империя
имя: имени имя имён
институт: институт института
инструмент: инструменты
интеллигенция: интеллигенции
искусство: искусств искусства
использование: использования
использовать: использующие
история: история
источник: источник
июль: июля
казань: казани казань
кайбица: кайбицы
картина: картины
категория: категории
классика: классика
книжный: книжной
код: код
кодекс: кодекс
коза: коза
конец: конца
конфиденциальность: конфиденциальности
короткий: короткий
край: край
кук: куки
кунгур: кунгур кунгуре
кырлай: кырлае
л: л
ленинград: ленинград ленинграда
ленинградский: ленинградского ленинградском
лес: лес
лист: листы
литература: литература литературы
лицензия: лицензии
малый: малые
март: марта
мастерская: мастерской
материал: материал
мать: мать
место: место
миновый: минов
мир: мир
мобильный: мобильная
москва: москве
мотив: мотивам
мочь: могут
музей: музее музей
муса: муса
мы: нами
н: н
навигация: навигации навигация
навои: навои
награда: награды
написать: написал
неизвестный: неизвестный
некоммерческий: некоммерческой
некоторый: некоторые
неопр: неопр
нович: нович
новый: нов новые
ноябрь: ноября
ныне: ныне
областной: областных
обращение: обращения
обсуждение: обсуждение
объединение: объединения
окончить: окончил
описание: описание
опытный: опытными
организация: организации
оренбургский: оренбургском
ортс: ортса
отв: отв
ответственность: ответственности
отдельный: отдельных
отец: отец
отечественный: отечественной
отказ: отказ
открытие: открытие
отличаться: отличаться
отредактировать: отредактирована
ошибка: ошибке
пейзаж: пейзажа
переехать: переехал
перейти: перейти
пермский: пермская пермский пермской пермском
пермь: перми
перо: перо
персоналия: персоналии
персональный: персональные
петербург: петербурге
петербургский: петербургской
печать: печати печать
плешивый: плешивый
поведение: поведения
подробный: подробнее
пожертвовать: пожертвовать
поиск: поиск поиску
пока: пока
политика: политика
получить: получив получить
портрет: портретов портреты
посвятить: посвящены
последний: последний
постоянный: постоянная
поэма: поэма поэме
править: править
правка: правки правок
представитель: представителей
представиться: представились
преподаватель: преподаватели
преподавать: преподавал
пресс: пресс
примечание: примечания
принимать: принимал
проверить: проверенной
проверка: проверки
проверяться: проверялась
продолжать: продолжая
проект: проектах
произведение: произведений
промышленный: промышленной промышленном
просмотр: просмотры
пространство: пространства
профессор: профессора
проходить: проходили
прощание: прощание
рабига: рабига
работа: работы
работать: работал
разработчик: разработчики
расширение: расширение
ребёнок: дети
ред: ред
релиз: релиз
репин: репина
родитель: родители
родиться: род родившиеся родились родился
рождение: рождении рождения
российский: российская
рсфср: рсфср
рт: рт
рудольф: рудольфа
русский: русский
сабирзян: сабирзянов
салават: салават
санкт: санкт
сведение: сведения
свежий: свежие
свободный: свободной
связанный: связанные
связаться: свяжитесь
село: села селах
семилетний: семилетнюю
семья: семья
сентябрь: сентября
серия: серию
синтезировать: синтезировать
система: системе
сказка: сказка
скачать: скачать
скрытый: скрытые
скульптура: скульптуры
служебный: служебные
случай: случаях
случайный: случайная
смерть: смерти
смотреть: см
событие: события
совершенствоваться: совершенствовался
советский: советский
содержание: содержание содержанию
создавать: создаёт
создать: создал созданных создать
сообщество: сообщество
сообщить: сообщить
сохранение: сохранением
союз: союз союза
справка: справка
ссср: ссср
ссылка: ссылка ссылки
станковый: станковые
статистика: статистика
статья: статьи статья
стих: стихам
страница: страница странице страницу страницы
сюда: сюда
так: т
также: также
танай: танай
тасср: тасср
тат: тат
татаро: татаро
татарский: татарская татарский татарской
татарстан: татарстана
татарча: татарча
ташкент: ташкент
творчество: творчество
театр: театре
текст: текст
текущий: текущая текущие
тематика: тематику
тематический: тематической
техникум: техникум
товарищ: товарищей
товарный: товарный
традиция: традиции
требовать: требуют
тукай: тукай тукаю
тукать: тукая
тушь: тушь
удаться: удалось
указание: указанием
улы: улы
умерший: умершие
условие: условий условия
участие: участие
участник: участниками
училище: училище
учёба: учёба
учётный: учётную
ф: ф
файзрахма: файзрахма
файзрахман: файзрахман файзрахмана
файзулла: файзулла
фамилия: фамилиями
фахим: фахим
фонд: фонд
форум: форум
френец: френца
х: х
холст: холсты
хороший: лучшие
художественно: художественно
художественный: художественный
художество: художеств
художник: художник художника художники художников художником
цитировать: цитировать
человек: людях
число: числе
читать: читать
член: член
школа: школу
шурал: шурале
шуралинский: шуралинский
экспорт: экспорт
элемент: элемент
энциклопедия: энциклопедии энциклопедия
этот: эта
ю: ю
юлай: юлаев
язык: языках
