август: августа
автопортрет: автопортрет
авторство: авторства
академический: академические академической
академия: академии
акка: акке
аклеить: аклея
аксель: аксель
активный: активен
аландский: аландские аландских
алфавит: алфавиту
андерссон: андерссон андерссона
анкёрса: анкерса
анна: анна анной анны
апрель: апреля
архивировать: архивировано
архитектор: архитектор архитектором
архитектура: архитектуры
ассоциация: ассоциация
баржа: барже
бегравнингсплатсный: бегравнингсплатсен
бездетный: бездетным
бельгия: бельгию
бергианский: бергианского
бергилунда: бергилунде
берег: берег
библиографический: библиографических
биографический: биографический
биография: биография
больший: большая большие
большой: большой
бонниер: бонниер
ботаника: ботаника
бразилия: бразилию
брак: брак брака
брат: братом
будущий: будущей
бунтарский: бунтарское
быть: будучи
ваксхольм: ваксхольм ваксхольме
вальдемарсудда: вальдемарсудде
васа: васа
вдохновение: вдохновение
век: века
венгберг: венгберг
вернер: вернер
версия: версия
вестерхольм: вестерхольм
весёлый: весёлого
ветер: ветер
взять: взял
видение: видении
викидать: викиданных
викимедиа: викимедиа
википедия: википедии википедия
викисклад: викисклад викискладе
виктор: виктор
вилла: вилла вилле виллу виллы
витализм: витализмом
вклад: вклад
вместе: вместе
внешний: внешние
внутренний: внутренние
вовлечь: вовлечены
воздух: воздух
возлагать: возлагал
возможно: возможно
возраст: возрасте
войти: войти
волшебный: волшебные
воспринимать: воспринимали
восстанавливать: восстанавливал
восток: востока
впечатление: впечатлением
время: времени время
встреча: встречи
всё: всё
выбросить: выброшенное
выполнить: выполнены
вырасти: вырос
галерея: галерее галереи галерея
генеалогия: генеалогия
гипсовый: гипсовые
год: года годами годах годов году годы лет
город: городе
гостить: гостили
готланд: готланд
густав: густав
гётеборгский: гётеборгском
дата: дата
два: двумя
де: де
девушка: девушка
действовать: действовала действовать
деятель: деятелей деятель
деятельность: деятельности
длительный: длительную
долгий: долгое
дом: дом дома доме
домик: домик
дополнительный: дополнительные
доставить: доставлен
доступный: доступен
друг: другом
другой: другими других
дружеский: дружескими
дюссельдорфский: дюссельдорфской
ева: ева еве евой
естественный: естественной
ещё: ещё
жанейро: жанейро
жена: жена женой
жениться: женился
живопись: живописи живопись
жизнь: жизни жизнь
завершить: завершено
заглавный: заглавная
закончить: закончил
заметить: замечен
занятие: занятия
занять: заняло
запись: запись
заполнить: заполнить
зарегистрировать: зарегистрированный
затем: затем
захариас: захариаса
заявление: заявление
зимний: зимней зимнюю
знак: знак
знакомый: знакомым
избранный: избранные
известный: известный известных
известняковый: известняковых
изготовить: изготовлен
изображать: изображала
изображение: изображения изображениями
изучать: изучал
иллюстрировать: иллюстрировал
именно: именно
иметь: имел
импрессионизм: импрессионизма
импрессионистичный: импрессионистичной
импрессионистский: импрессионистский
имя: имя имён
инструмент: инструменты
искусство: искусств искусства
использование: использования
использовать: использующие
исследовательский: исследовательских
история: истории история
источник: источник источниками
италия: италию
итальянский: итальянской
июль: июля
капитан: капитана
карин: карин
карл: карл
картина: картинах картиной картину картины
карьера: карьера
каталог: каталогах
категория: категории
кафедральный: кафедральном
кладбище: кладбище
книга: книг книге
код: код
кодекс: кодекс
колония: колонии колония
контекст: контекстом
конфиденциальность: конфиденциальности
копия: копией
королевский: королевской
король: королём
короткий: короткий
который: которая которого которые который
крупный: крупной
кук: куки
культурный: культурных
купаться: купающийся
куратор: куратором
лапландия: лапландию
ларссон: ларссон
леандр: леандра
лена: лене
лесной: лесной
летний: летней летний летняя
лето: лета
линдстрёма: линдстрём
лицензия: лицензии
лодка: лодка
луч: лучи
любить: любил
лёд: льду
мальчик: мальчик
мария: марией
материал: материал
мать: мать
мебель: мебель
медиафайл: медиафайлы
менее: менее
место: место местом
металлический: металлическом
мобильный: мобильная
модерн: модерн модерна
молодой: молодым
море: моря
мочь: могут
мужчина: мужчинами
музей: музее музея
мы: нами
мысль: мыслях
мятежный: мятежным
навигация: навигации навигация
надежда: надежды
нанести: нанесла
написать: написал
например: например
наружное: наружные наружным
настенный: настенные
настроение: настроение
натурализм: натурализма
находиться: находится
нацеливаться: нацеливались
национализм: национализме
национальный: национального национальном
начать: начали
невероятный: невероятные
некоммерческий: некоммерческой
некоторый: некоторое некоторыми
некрополистик: некрополистика
немного: немного
неопр: неопр
несколько: несколько
нидерланды: нидерланды
нильс: нильс нильса
новый: новые
норвежский: норвежская
норра: норра
ночной: ночная
обнажённый: обнажённого
обращение: обращения
обсуждение: обсуждение
обучение: обучение
общение: общения
один: одним одними
однако: однако
одновременно: одновременно
описание: описание
организация: организации
орс: орсе
основатель: основателем
основное: основном
особенно: особенно
остаться: остался
остров: острова островах острове
ответственность: ответственности
отделка: отделка
отдельный: отдельных
отец: отец отца
отказ: отказ
отклонить: отклонена
открытый: открытым
отношение: отношению отношения
отправить: отправлена
отредактировать: отредактирована
отчасти: отчасти
офорт: офорт
ошибка: ошибке
паковый: паковом
памятник: памятником
пара: пара
парижский: парижский
первый: первые первый
переехать: переехал
перейти: перейти
персея: персея
персоналия: персоналии
персональный: персональные
печать: печати печать
пират: пирата
писать: писал писала
пляжный: пляжный
поведение: поведения
повлиять: повлияло
подготовительный: подготовительной
подробный: подробнее
поезд: поезде
поездка: поездка поездках поездки поездку
пожертвовать: пожертвовать
поздний: позднего позже
познакомиться: познакомился
поиск: поиск поиску
покрасочный: покрасочные
политика: политика
полностью: полностью
получать: получал
получить: получить
поначалу: поначалу
порок: порока
портрет: портрет портреты
последний: последней последний
постоянный: постоянная
построить: построена
похоронить: похороненные
похоронный: похоронен
почтовый: почтовая
править: править
правка: правки
праздник: праздник
пребывание: пребывания
предварительно: предварительно
представить: представлены
представиться: представились
предшественник: предшественнике
прибывать: прибывали
приехать: приехал
признать: признан признана
пример: примеров
примерно: примерно
примечание: примечания
примкнуть: примкнул
принц: принца
приобрести: приобрела
причина: причинам
проводить: проводила
продать: продан
продолжать: продолжал
проект: проектах
проектировать: проектировал
просмотр: просмотры
проспект: проспект
пространственный: пространственным
пространство: пространства
профессор: профессора
проявляться: проявляться
псевдоним: псевдонимом
пять: пять
работа: работ работой работы
работать: работал
разработать: разработал
разработчик: разработчики
разрываться: разрывался
ранний: ранние ранних
рассказ: рассказов
рассказывать: рассказывает
расширение: расширение
расширять: расширял
ратуша: ратуше
реализовать: реализовал
ребёнок: детей дети ребёнком
резиденция: резиденции резиденцию резиденция
рельеф: рельефы
реставрация: реставрации
ресурс: ресурсы
рикарда: рикард
рио: рио
рисовать: рисовал
рисунок: рисунками
родиться: род родившиеся
рождение: рождении рождения
роль: роли
романтический: романтическом
роса: роса
роспись: росписей
русский: русский
рыбалка: рыбалку
ряд: ряд
сад: сада
сайт: сайты
салон: салон
сам: самим
самый: самый самых
сведенборг: сведенборга
сведение: сведения
свежий: свежие
свет: свет света светом
свободный: свободной свободных
свой: своего своей своим своих своё
свойство: свойство
связанный: связанные
связать: связаны
связаться: свяжитесь
северный: северном
семейный: семейной
семья: семьи семья семьёй
сентябрь: сентября
сердце: сердца
середина: середины
серия: серию
сестра: сёстры
сильный: сильным
символизм: символизма
система: системе
скачать: скачать
склеп: склепе
скончаться: скончался
скоропостижно: скоропостижно
скрытый: скрытые
скульптор: скульптор скульпторы
словарь: словари
служебный: служебную служебные
служить: служила
случай: случаях
случайный: случайная
смерть: смерти
смотреть: см
снежный: снежный
собор: соборе
собственный: собственный
событие: события
совершить: совершил
содержание: содержание
содержать: содержать
создать: создать
солнечный: солнечного солнечные
солёный: солёный
сообщество: сообщество
сообщить: сообщить
сопровождать: сопровождал
сотрудничество: сотрудничестве
сохранение: сохранением
сохраниться: сохранившемся
способ: способ
справка: справка
спроектировать: спроектировал
среда: среду
среди: среди
средневековый: средневековых
ссылка: ссылка ссылки
статистика: статистика
стать: стал стала стали
статья: статьи статья
стенхаммар: стенхаммаром
стиль: стиле стиль
стокгольм: стокгольм стокгольме
стокгольмский: стокгольмской
страна: страна
страница: страница странице страницу страницы
странный: странного
строитель: строителем
студент: студентом
студия: студией
стул: стул
супруг: супруга супруги
схематичный: схематичной
сын: сына сыном
сюда: сюда
также: также
такой: таких
творческий: творческую
текст: текст
текущий: текущие
тело: тела тело
тематический: тематические
тесть: тестя
тигерхильм: тигерхильм
тигеръельма: тигеръельм
тиль: тиля
товарный: товарный
топелиус: топелиус топелиуса
торсвить: торсви
торё: торё
трёхлетний: трёхлетнего
удовольствие: удовольствие
указание: указанием
указать: указан
украшение: украшения
уменьшить: уменьшенной
умерший: умершая умершие
уппсалы: уппсалы
управление: управлении
упрощённый: упрощённом
условие: условий условия
усыновить: усыновили усыновлён
утренний: утренний
участвовать: участвовал участвовала
участие: участие
участок: участок
учебный: учебные
учиться: учился
учёба: учёбу
учётный: учётную
ущерб: ущерб
фамилия: фамилией фамилию
фамильный: фамильном
фаусто: фаусто
февраль: февраля
финляндия: финляндии
финский: финский финскими финской
фон: фон
фонд: фонд
форум: форум
франция: францию
фреска: фрески
х: х
ханс: хансом
хейденст: хейденстам
храм: храм
художественный: художественная художественной художественном художественную
художник: художник художника художникам художниками художники художников художником
художница: художницей художницы
царить: царило
цвет: цветом
цветочный: цветочными
цитировать: цитировать
чайка: чайка
часто: часто
чей: чьего
человек: людях человека
человеческий: человеческого
чередовать: чередовала
черпать: черпал
читать: читать
член: членом
чтение: чтение
чувство: чувства
шалость: шалостях
швед: швед
шведский: шведский шведских шведского шведской шведскую
шведско: шведско
швеция: швеции швецию швеция
школа: школе школы
эдвард: эдварда
экономический: экономический экономическим
экспорт: экспорт
экспрессионизм: экспрессионизма
элемент: элемент элементы
элиас: элиаса
энергичный: энергичного
эннингебь: эннингебю
энциклопедия: энциклопедии
эрнст: эрнстом
это: это
этот: эта
юмор: юмором
юхан: юхан юхана юхану
являться: являлся
язык: язык языках
