абай: абая
абдраева: абдраева
автор: автор
авторство: авторства
аида: аида
айболит: айболит
айдар: айдар
айтматов: айтматова
айчурек: айчурек
айша: айша
академия: академия
алан: алан
алеко: алеко
алма: алма
алтын: алтын
алфавит: алфавиту
аманбаев: аманбаева
амиров: амирова
анар: анар
анатол: анатол
анатолий: анатолий
анатолый: анатолый
анджело: анджело
аре: аре
аренский: аренского
ареф: ареф
арефьев: арефьев арефьевы
артёмовский: артемовского
архивировать: архивировано
аршин: аршин
асафьева: асафьева
асель: асель
ата: ата
б: б
бажан: бажана
балет: балет балета балеты
балетный: балетные балетных
барышня: барышня
бахчисарайский: бахчисарайский
берег: берегах
биза: бизе
биографический: биографические
бишкек: бишкек
богдан: богдан
больший: большая
большой: большой
борис: борис
борисов: борисова
бородин: бородина
боярский: боярского
брусиловский: брусиловского
бульб: бульба
быть: е
бюро: бюро
вальс: вальс
василиевич: васильевич
васильович: васильович
век: века
великий: великой
верди: верди
версия: версии версия
верховный: верховного
весна: весна
викидать: викиданных
викимедиа: викимедиа
википедия: википедии википедия
вклад: вклад
вкп: вкп
владимир: владимир
власов: власова
внешний: внешние
война: войне войны
войти: войти
волк: волк
волшебный: волшебные
вступление: вступление
выпускник: выпускники
выставка: выставках
г: г
гаджибеков: гаджибекова
гатоб: гатоб
германия: германией
германов: германова
главный: главный
глиэра: глиэра
го: го
год: гг года годах году лет
годунов: годунов
горьковский: горьковском
государственный: государственная
гофман: гофмана
грамота: грамоты
граница: границ
гулак: гулак
гуно: гуно
гюго: гюго
далее: д
дама: дама
данькевич: данькевича
даргомыжский: даргомыжского
дата: дата
дать: дала данные
действовать: действовать
декорация: декораций
депутат: депутат
деятель: деятели деятель
деятельность: деятельности
дж: дж
джалиль: джалиля
джамиль: джамиля
джульетта: джульетта
джусупов: джусупова
дзержинский: дзержинского
дзюба: дзюба
длина: длиною
днепр: днепре
днепропетровск: днепропетровск днепропетровске
днепропетровский: днепропетровский днепропетровского днепропетровском
дникнуть: дник
дов: дов
доктор: доктор
дон: дон
дополнительный: дополнительные
доступный: доступен
др: др
драма: драма драмы
другой: других
дунай: дунаем
евгений: евгений
египетский: египетские
енциклопед: енциклопед
ещё: ещё
жанр: жанр
жибек: жибек
жуан: жуан
жуковский: жуковский
з: з
заглавный: заглавная
занятие: занятий
запись: запись
запорожец: запорожец
зарегистрировать: зарегистрированный
заслужить: заслуженные заслуженный
заявление: заявление
звание: звания
звезда: звезды
знак: знак
знамя: знамени
знать: знает
игорь: игорь
идти: идёт
избранный: избранные
избрать: избран
изд: изд
издание: издание
изменение: изменения
изображение: изображений
изобразительный: изобразительного
имя: имени имён
инструмент: инструменты
иоланта: иоланта
искусство: искусств искусства
искусствовед: искусствовед
испанский: испанское
использование: использования
использовать: использующие
иссык: иссык
история: история
источник: источник источниками
итоговый: итоговую
й: й
кавалер: кавалеры
казань: казань
казахский: казахский казахской
кандидат: кандидатом
кантти: кантти
каприччио: каприччио
кармена: кармен
картина: картин картину
категория: категории
киев: киев
ким: ким
кино: кино
киргизия: киргизии
киргизский: киргизский киргизского киргизской
киров: кирова
кладбище: кладбище
князь: князь
код: код
кодекс: кодекс
кокуль: кокуль
колодец: колодец
командир: командиры
комедия: комедия
конфиденциальность: конфиденциальности
координационный: координационное
короткий: короткий
корсаков: корсакова
кп: кп
кпсс: кпсс
красавица: красавица
красный: красного красной красный
красота: красота
крейн: крейна
кудрицкий: кудрицкого
кудрицький: кудрицький кудрицького
кук: куки
куль: куля
купить: купить
кучеренко: кучеренко
кыз: кыз
кыргызский: кыргызский
кыргызстан: кыргызстана
кыргызча: кыргызча
л: л
лаб: лаб
лабинский: лабинский
лауреат: лауреаты
лауренсия: лауренсия
лебединый: лебединое
ленин: ленина
ленинградский: ленинградский
леонкавалло: леонкавалло
летопись: летопись
литература: литература
лицензия: лицензии
лупандин: лупандина
лысенко: лысенко
м: м
май: мая
майсара: майсары
майский: майская
мак: мак
макет: макеты
малдыбаев: малдыбаева
маленький: мал
манас: манас
мастер: мастер
материал: материал
мать: матери
медаль: медали медаль медалью
место: место
мистецтво: мистецтво
мобильный: мобильная
могила: могилы
молчанов: молчанова
морозов: морозова
москва: москва москве
московский: московские
мочь: могут
музыка: музыку
музыкальный: музыкальная
муса: мусы
мусоргский: мусоргского
мы: нами
н: н
навигация: навигации навигация
награда: награды
наградить: награждённые
нана: нан
народ: народа
народный: народные народный
наука: наук
научный: научное
национальный: национальная национальной
невеста: невеста
неизвестный: неизвестный
некоммерческий: некоммерческой
некролог: некролог
неоднократно: неоднократно
неопр: неопр
нижегородский: нижегородский
новый: новая новые
ночь: ночи ночь
ноябрь: ноября
нська: нська
нський: нський
ныне: ныне
область: область
обращение: обращения
обсуждение: обсуждение
общество: общество
ограф: ограф
одесский: одесский
один: одна
одноимённый: одноимённой
ожидать: ожидают
озеро: озеро
окончить: окончил
октябрь: октября
онегин: онегин
опера: оперы
оперетта: оперетта
оперный: оперного оперные оперных
описание: описание
опричник: опричник
оптимистический: оптимистическая
организация: организации
орден: орден ордена
оркестровка: оркестровке
основа: основе
ответственность: ответственности
отдельный: отдельных
отечественный: отечественной
отказ: отказ
отредактировать: отредактирована
оформить: оформил оформленные
оформление: оформление
оффенбах: оффенбаха
оценить: оценить
оценка: оценку
ошибка: ошибке
п: п
паяц: паяцы
педагогический: педагогический
пенза: пенза пензе
пензенский: пензенского
перейти: перейти
персоналия: персоналии
персональный: персональные
петя: петя
пехотинец: пехотинцы
печать: печати печать
пиковый: пиковая
победа: победу
поведение: поведения
подвиг: подвиг
подробный: подробнее
пожертвовать: пожертвовать
поиск: поиск поиску
политика: политика
получить: получить
последний: последний
поставить: поставленный
постоянный: постоянная
поступить: поступил
похоронить: похороненные
похоронный: похоронен
почётный: почётные
править: править
правка: правки
представиться: представились
представление: представления
президиум: президиума
премия: премии премия
примечание: примечания
проверить: проверена
проверка: проверки
продать: проданная продать
проделка: проделки
проект: проектах
прокофьев: прокофьева
просмотр: просмотры
пространство: пространства
прохоров: прохорова
пуня: пуни
пуччини: пуччини
пушкин: пушкина
р: р
работать: работал
разработчик: разработчики
ранить: ранен
рассвет: рассвета
раухвергер: раухвергера
рахманинов: рахманинова
ред: ред
редакция: редакция
ресурс: ресурсы
решение: решений
риголетто: риголетто
римини: римини
римский: римского
родиться: род родившиеся родился
рождение: рождения
ромео: ромео
россинь: россини
россия: россии россия
рот: рот
рсфср: рсфср
рубеж: рубежом
русалка: русалка
русский: русский
самаркандский: самаркандский
самарский: самарская
сан: сан
сведение: сведения
свежий: свежие
свободный: свободной
связанный: связанные
связаться: свяжитесь
севильский: севильский
семья: семья
сентябрь: сентября
сердце: сердце
симфонический: симфонической
система: системе
сказка: сказки
скачать: скачать
скрытый: скрытые
сл: сл
словарь: словари
служебный: служебные
случай: случаях
случайный: случайная
смерть: смерти
сметана: сметаны
смотреть: см
событие: события
совет: совета
советский: советская советские советский советского
современный: современной
содержание: содержание
создать: создать
созыв: созывов
солдат: солдат
сообщество: сообщество
сообщить: сообщить
сост: сост
сохранение: сохранением
союз: союза
спартак: спартак
спать: спящая
спектакль: спектаклей спектакля
справка: справка
справочник: справочник
сср: сср
ссср: ссср
ссылка: ссылка ссылки
стабильный: стабильная
ставрополь: ставрополе ставрополь
статистика: статистика
статья: статьи статья
степень: степени
страна: страна
страница: страница странице страницу страницы
сцена: сцене
сценограф: сценограф сценографы
сценография: сценография
сын: сын
сюда: сюда
сюита: сюита
так: т
тарас: тарас тараса
татарский: татарский
татьяна: татьяна
ташкент: ташкент
творчество: творчества творчество
театр: театр театра театре
театральный: театральная театральные
текст: текст
текущий: текущая текущие
теремок: теремок
территория: территория
техникум: техникум
тип: тип
тихий: тихий
товарный: товарный
токтогул: токтогул
тольятти: тольятти
травиата: травиата
трагедия: трагедия
трудовой: трудового
тулеев: тулеева
тысяча: тысяча
тьма: тьма
узбекский: узбекский
указание: указанием
укр: укр
укра: укра
украина: украина украины
украинский: украинская украинской
укротитель: укротителя
укрощение: укрощение
умереть: умер
умерший: умершие
упоряд: упоряд
условие: условий условия
усср: усср
участие: участие
участник: участник
участок: участок
училище: училища
учёба: учёба
учётный: учётную
ф: ф
фамилия: фамилией
фантазия: фантазии
фауст: фауст
фейгин: фейгина
фер: фере
флетчер: флетчера
фонд: фонд
фонтан: фонтан
форум: форум
франческа: франческа
фрунзе: фрунзе
фьев: фьев
хачатурян: хачатуряна
хмельницкий: хмельницкий
хованский: хованском
холминовый: холминова
хпт: хпт
художественно: художественно
художественный: художественного
художник: художник художника художники художников
хулиган: хулиган
ц: ц
цена: цена
центральный: центральная
цирюльник: цирюльник
цитировать: цитировать
цк: цк
ч: ч
чайковский: чайковского
час: час
человек: людях человек
черевичек: черевички
четверть: четверть
чио: чио
читать: читать
член: член членом члены
чние: чний
чолпон: чолпон
шаблон: шаблонов
шевченко: шевченко
шевченковский: шевченковские
широта: ш
шопен: шопена
шопениана: шопениана
шостакович: шостаковича
шпаковский: шпаковская
щедрин: щедрина
экз: экз
экспонироваться: экспонировались
экспорт: экспорт
элемент: элемент
энергия: энергия
энциклопедический: энциклопедический энциклопедическую
энциклопедия: энциклопедии энциклопедия
эскиз: эскизы
эсмеральда: эсмеральда
этот: эта
юдакова: юдакова
язык: языках
январь: января
