авторство: авторства
агитация: агитации
агитплакат: агитплакате
академический: академического
алфавит: алфавиту
аркадий: аркадий
арсеньев: арсеньев
б: б
бама: бама
беречь: берегите
богатство: богатство
борисович: борисович
век: века
версия: версия
викидать: викиданных
викимедиа: викимедиа
википедия: википедии википедия
вклад: вклад
влксм: влксм
внешний: внешние
войти: войти
восток: востоку
вперёд: вперед
всесоюзный: всесоюзном всесоюзных
выпускник: выпускники
выставка: выставок
выше: выше
год: год года году годы
государственный: государственного
график: график
дальний: дальнему
дата: дата
действовать: действовать
деятель: деятели
добавить: добавить
дополнительный: дополнительные
доступный: доступен
другой: других
ежегодный: ежегодной
ещё: ещё
живописец: живописец
заглавный: заглавная
заместитель: заместителем заместитель
запись: запись
зарегистрировать: зарегистрированный
зарубежный: зарубежных
заслужить: заслуженные заслуженный
заявление: заявление
звание: звания
знак: знак
избранный: избранные
издательство: издательстве
изображение: изображения
изобразительный: изобразительного изобразительном
имя: имени имён
институт: института
инструмент: инструменты
искусство: искусств искусства искусстве
использование: использования
история: история
источник: источник
июль: июля
категория: категории
качество: качество
код: код
кодекс: кодекс
коллекция: коллекциях
комиссия: комиссии
конкурс: конкурсе
конфиденциальность: конфиденциальности
короткий: короткий
красота: красоту
кук: куки
куратор: куратором
лететь: лети
лицей: лицея
лицензия: лицензии
м: м
март: марта
мастерская: мастерской мастерскую
материал: материал
мгха: мгхи
место: место
мир: мир
мобильный: мобильная
москва: москва москве
московский: московских московского московскую
мосха: мосха
мочь: могут
музей: музеев
мы: нами
н: н
навигация: навигации навигация
наглядный: наглядной
награда: награды
народ: народ
народный: народные народный
находиться: находятся
наш: нашей
некоммерческий: некоммерческой
неопр: неопр
новый: новые
обращение: обращения
обсуждение: обсуждение
окончить: окончил
октябрь: октября
описание: описание
организация: организации
основной: основные
ответственность: ответственности
отдельный: отдельных
отказ: отказ
отредактировать: отредактирована
ошибка: ошибке
первый: первая
перейти: перейти
персоналия: персоналии
персональный: персональные
печать: печати печать
плакат: плакат плаката плакату плакаты
плакатист: плакатист плакатисты
плакатный: плакатной
победить: победит
поведение: поведения
подробный: подробнее
пожертвовать: пожертвовать
поиск: поиск поиску
полевой: полевых
политика: политика
получить: получить
пономарёв: пономарева
последний: последний
постоянно: постоянно
постоянный: постоянная
править: править
правка: правки
председатель: председателем председатель председателя
представиться: представились
прежде: прежде
премия: премии премия
природа: природы
проект: проектах
проехать: проехать
произведение: произведения
производственный: производственной
пройти: пройти
просмотр: просмотры
пространство: пространства
пусть: пусть
работа: работ
работать: работал
различный: различных
разработчик: разработчики
рельс: рельсам
республиканский: республиканских
родина: родине
родиться: родившиеся
рождение: рождения
российский: российский российских российской
россия: россии россия
рсфср: рсфср
русский: русский
савостюк: савостюка
сведение: сведения
свежий: свежие
свободный: свободной
связанный: связанные
связаться: свяжитесь
секретарь: секретарь
секция: секции
система: системе
скачать: скачать
слава: слава
служебный: служебные
случай: случаях
случайный: случайная
смерть: смерти
смотреть: см
событие: события
совет: совета
советский: советский
содержание: содержание
создать: создать
солнце: солнце
сообщество: сообщество
сообщить: сообщить
сотрудничать: сотрудничал
сохранение: сохранением
союз: союза
справка: справка
средний: среднюю
ссср: ссср
ссылка: ссылка ссылки
становиться: становился
статистика: статистика
статья: статьи статья
страна: страна
страница: страница странице страницу страницы
строитель: строителям
строить: строим
суриков: сурикова
сх: сх
сюда: сюда
творческо: творческо
текст: текст
текущий: текущие
тиражный: тиражные
товарный: товарный
трамвай: трамвай
труд: труду
удостоить: удостоен
указание: указанием
умерший: умершие
условие: условий условия
успенский: успенского
участие: участие
участник: участник
учиться: учился
учёба: учёба
учётный: учётную
фамилия: фамилией
федерация: федерации
фонд: фонд
форум: форум
хлебороб: хлебороба
художественный: художественного художественную
художник: художник художники художников
хф: хф
цитировать: цитировать
цк: цк
человек: людях
черёмный: черемных
честь: честь
чили: чили
читать: читать
член: член члены
школа: школу
шпала: шпалам
экспорт: экспорт
элемент: элемент
энциклопедия: энциклопедии
этот: эта
язык: языках
