авторство: авторства
академический: академическое
алфавит: алфавиту
альманах: альманах
анурина: анурин анурина
апрель: апреля
артереть: артру
архив: архивов
архивировать: архивировано
архитектура: архитектуры
б: б
бегов: беговой
бессмертный: бессмертный
биография: биографии биография
боевой: боевые
век: века
великий: великой
версия: версия
весенний: весенним
викидать: викиданных
викимедиа: викимедиа
википедия: википедии википедия
вклад: вклад
возвышенность: возвышенности
воин: воин
война: войны
войти: войти
выпускник: выпускники
выставка: выставка выставке выставки выставок
г: г
галерея: галерея
гбоу: гбоу
год: год года годах году лет
годовщина: годовщине
горелов: горелова
город: города городов
городской: городской
государственный: государственное государственный
губерния: губерния
дальнейший: дальнейшем
дата: дата даты
действовать: действовать
день: дней дня
деятель: деятели
деятельность: деятельности
дзержинский: дзержинский
добавить: добавить
дополнительный: дополнительные
достоевский: достоевского
доступный: доступен
друг: друзья
другой: другие других
дума: думе
елисеев: елисеев
ещё: ещё
заглавный: заглавная
загс: загс
занимать: занимал
занятие: занятий
запись: запись
зарегистрировать: зарегистрированный
заслонить: заслонили
заслуга: заслуги
заявление: заявление
знак: знак
избранный: избранные
изображение: изображением
изобразительный: изобразительного
изолировать: изолированные
империя: империя
импрессионист: импрессионистом
имя: имени имён
индустрия: индустрия
инструмент: инструменты
информация: информация
иогансон: иогансона
искусство: искусства
использование: использования
исторический: исторический
история: история
источник: источник источники источников
июль: июля
июнь: июня
й: й
кавалер: кавалеры
картинный: картинная
каталог: каталог
категория: категории
код: код
кодекс: кодекс
коллекция: коллекциях
комиссия: комиссии
компонент: компонентом
конкретизация: конкретизации
конфиденциальность: конфиденциальности
короткий: короткий
кпсс: кпсс
красноармейск: красноармейска
кук: куки
ленинград: ленинграда
летие: летию
липецк: липецк
липецкий: липецкая липецкой
лирический: лирические
лицензия: лицензии
м: м
май: мая
март: марта
материал: материал
мах: маху
медаль: медалью
международный: международных
место: место
многий: многих
мобильный: мобильная
москва: москва москве
московский: московского московское московской
мосха: мосх мосха
мочь: могут
музей: музей музеях
мы: нами
н: н
навигация: навигации навигация
награда: награды
наградить: награждённые
называть: называли
находиться: находятся
начало: начала
недостаток: недостатков
некоммерческий: некоммерческой
неопр: неопр
новый: новые
ныне: ныне
область: области
оборона: оборону
образование: образование образования
обращение: обращения
обсуждение: обсуждение
окончить: окончил
описание: описание
организация: организации
орден: ордена
основное: основном
ответственность: ответственности
отдельный: отдельных
отечественный: отечественной
отказ: отказ
отредактировать: отредактирована
официальный: официального официальном
ошибка: ошибке
п: п
память: памяти
пейзаж: пейзажи
пейзажист: пейзажисты
перейти: перейти
персоналия: персоналии
персональный: персональная персональные
печать: печати печать
поведение: поведения
подробный: подробнее
пожалуйста: пожалуйста
пожертвовать: пожертвовать
поиск: поиск поиску
политика: политика
полк: полк
получить: получил получить
посвятить: посвященная посвященный
последний: последний
пост: пост
постоянный: постоянная
править: править
правка: правки
председатель: председателя
представиться: представились
примечание: примечания
принять: принятыми
проект: проектах проекты
просмотр: просмотры
пространство: пространства
протасьев: протасьево
профессиональный: профессиональных
пустой: пустым
пётр: петр пётр
работа: работ работы
разработчик: разработчики
район: районе
раненбургский: раненбургский раненбургском
региональный: региональных
реестр: реестр
рекомендация: рекомендациями
ркк: ркка
родиться: род родившиеся родился
родственный: родственные
рождение: рождения
российский: российская российский российских
россия: россии россия
рубеж: рубежом
руководство: руководством
русский: русский русским
рязанский: рязанская
сайт: сайт сайта сайте
сведение: сведения
свежий: свежие
светлый: светлые
свободный: свободной
связанный: связанные
связать: связать
связаться: свяжитесь
связист: связист связисты
себя: собой
село: селе село
система: системе
скачать: скачать
скрытый: скрытые
служебный: служебные
служить: служил
случай: случаях
случайный: случайная
смерть: смерти
смотреть: см
событие: события
современник: современники
содержание: содержание
создать: создать
сообщество: сообщество
сообщить: сообщить
соответствие: соответствии
сохранение: сохранением
союз: союза
справка: справка
среднерусский: среднерусской
ссср: ссср
ссылаться: ссылаются
ссылка: ссылка ссылки
старинный: старинных
статистика: статистика
статья: статьи статью статья
степень: степени
столетие: столетию
страна: страна страну
страница: страница странице страницу страницы
съезд: съезду
сюда: сюда
так: т
творческий: творческие
творчество: творчество
текст: текст
текущий: текущие
тип: тип
товарный: товарный
требовать: требующие
уезд: уезд уезде
указание: указанием
указать: указан
умерший: умершие
управление: управление
условие: условий условия
установить: установите
утверждение: утверждениями
участие: участие
участник: участник
училище: училище
учёба: учёба
учётный: учётную
ф: ф
фамильный: фамильные
фонд: фонд
форум: форум
художественный: художественное художественных
художник: художник художника художники художников художником
ценность: ценности
цитировать: цитировать
чаплыгинский: чаплыгинском
частный: частных
часто: часто
человек: человек
читать: читать
член: член члена члены
шаблон: шаблонами шаблоном
школа: школа
экспорт: экспорт
электронный: электронный
элемент: элемент
энциклопедия: энциклопедии энциклопедия
этнокультурный: этнокультурным
этот: эта
язык: языках
яковлевич: яковлевич
