абсалямов: абсалямова
август: августа
автор: автором
авторство: авторства
авылларын: авылларыны
агач: агач
административный: административное
айдар: айдаров
айдаров: айдарова айдарову
айдаровой: айдаровой айдаровых
айсылу: айсылу
академик: академика
академический: академический
академия: академии
акварелист: акварелисты
акварель: акварелей акварели акварель акварелью акварелях
акварельд: акварельд
акварельный: акварельная акварельных
актаныш: актаныш
актанышский: актанышский
активист: активисты
активно: активно
актуальный: актуального актуальные
алина: алина
алфавит: алфавиту
альбина: альбина
альма: альма
англ: англ
ансамбль: ансамблей
апрель: апреля
аргумент: аргументы
арск: арск арске
арский: арский
артэп: артэп
архивировать: архивировано
архитектор: архитектор архитектора архитекторов архитектором архитекторы
архитектура: архитектура архитектуре архитектурой архитектуры
архитектураса: архитектурасы
архитектурный: архитектурно архитектурного архитектурной архитектурную архитектурные архитектурный архитектурных
аспирантура: аспирантуру
асср: асср
атмосфера: атмосферу
аттестат: аттестатов
б: б
байрамов: байрамова
балкон: балконов
балык: балык
баня: бани
башында: башында
белый: белым
библиографический: библиографических
библиография: библиография
бизнес: бизнес
биналар: биналары
биография: биографии биография
биолог: биолог
бистый: бист
благодарность: благодарность
болгар: болгара
болгария: болгарии
больший: большую наибольшего
большой: большой
брат: брат
будущий: будущей
булгать: булган
быт: быта
быть: будучи е суть
вахитовский: вахитовского
ведомость: ведомости
век: вв века веков
версия: версия
вестник: вестник
ветхий: ветхого
вечерний: вечерняя
вид: видами виде видов виды
викидать: викиданных
викимедиа: викимедиа
википедия: википедии википедия
викисклад: викисклад викискладе
вклад: вклад
вместе: вместе
внешний: внешние
внимание: внимание
возрождение: возрождения
войти: войти
волга: волги
волков: волкова
волшебный: волшебные
вопрос: вопросы
воссоздание: воссозданием
время: время
вручение: вручение вручении
вручить: вручено
всероссийский: всероссийских
второй: второй
выдача: выдаче
выдвигаться: выдвигался
выполнить: выполненной
выпускник: выпускники
выпустить: выпущенная
выставка: выставка выставках выставки
выставочный: выставочные
выступить: выступил
г: г
габдулла: габдуллы
газета: газета
гайсин: гайсин
галина: галина
галиуллин: галиуллина
гасыр: гасыр
гать: гать
гел: гел
германия: германии
гиззата: гиззата
главное: главного
главный: главным
год: год года годах году годы
горникнуть: горник
город: городам городах городов
городской: городского городскому городскую
госархстройконтроль: госархстройконтроля
гостиница: гостиницы
государственный: государственного государственной государственный государственными
градозащитный: градозащитного
граница: границу
графика: графике графики
графикада: графикада
графический: графического
греция: греции
грядущий: грядущего
гуашь: гуашью
далее: д
дальнейший: дальнейшем
дата: дата
дача: дача
дверной: дверных
движение: движения
действовать: действовать
декабрь: декабря
декоративный: декоративного
деревянный: деревянная деревянного деревянной деревянному деревянные деревянный деревянных
деталь: деталей
детальный: детальным
детство: детстве
деятель: деятели
деятельность: деятельности деятельность
дизайн: дизайна
династия: династия
диплом: диплом
директор: директором
диссертация: диссертацией диссертацию диссертация
дом: дом дома домах доме домов
дополнительный: дополнительные
достигнуть: достигнув
достижение: достижения
доступный: доступен
доцент: доцента доцентом
древний: древнего
древность: древностей
другой: других
духовный: духовное
египет: египта
единение: единение
ершовый: ершова
ещё: ещё
её: её
жанр: жанре жанром
жена: жена женой
живопись: живописи живопись
жизнь: жизнь
жилой: жилой жилые жилых
жильё: жилья
журнал: журнал
забиров: забирова
забировой: забировой
завойский: завойского
заглавный: заглавная
загородный: загородном
заинтересоваться: заинтересовался
заман: заман
занимать: занимает занимал
заниматься: занимался
занятие: занятий
заняться: занялся
запечатлеть: запечатлел
запечатлять: запечатляемого
запись: запись
заполнить: заполнить
зарегистрировать: зарегистрированный
заслуга: заслуг
заслужить: заслуженного заслуженные заслуженный
застройка: застройки застройкой
затем: затем
защитить: защитил
заявление: заявление
звание: звание званий звания
здание: здание зданий здания
зе: зе
знак: знак знаком
значительный: значительное
зодчество: зодчества зодчеству
иванычев: иванычева
играть: играл
идель: идель
идентичный: идентичного
избранный: избранные
известный: известен известны
изображение: изображением изображениями
изобразительный: изобразительного изобразительных
изучение: изучения
икона: икон
ильяс: ильяс
имя: имени имён
индивидуальный: индивидуальные
индийский: индийский
инженерный: инженерно
институт: институт института
инструмент: инструменты
интернет: интернет
интерьер: интерьеры
информация: информации
иск: иске
искусство: искусств искусства
испания: испании
использование: использования
использовать: использующие
исследователь: исследователи
исток: истоков
исторический: историческим исторического исторической
история: история
источник: источник
ит: ит
италия: италии
итог: итогом
июль: июля
июнь: июня
й: й
йяр: йяр
кадыров: кадырова
каждый: каждая
казан: казан
казанец: казанцам
казанна: казанны
казанский: казанские казанский казанского казанском
казань: казани казань
калыгин: калыгина
кандидат: кандидат кандидата кандидаты
канзафаров: канзафарова
караганда: караганда
каримов: каримова
картина: картин
каталог: каталогах
категория: категории
кафедра: кафедры
кгасу: кгасу
кебек: кебек
кечий: кече
кинотеатр: кинотеатры
книга: книг книги книгу
код: код
кодекс: кодекс
коллекция: коллекцию
командировка: командировок
компания: компании
комплекс: комплекс комплексы
композиция: композиция
конкурсный: конкурсных
конфиденциальность: конфиденциальности
короткий: короткий
корчма: корчмы
который: котором которую который которых
красный: красное
кремль: кремле кремля
кук: куки
культура: культуре культуры
культурный: культурного
кумгановый: кумганов
л: л
латыпов: латыпова
лесной: лесные
летие: летия
ликвидация: ликвидации
литература: литература
лицензия: лицензии
личный: личная
любовь: любовь
люция: люция
м: м
май: май
малое: малым
малый: малейших малых
манера: манеры
март: марта
масло: маслом
маслобойка: маслобоек
мастерская: мастерскую
материал: материал
мать: мать
матёрый: матер
машинка: машинок
медаль: медаль медалью
медиафайл: медиафайлы
медресе: медресе
международный: международных
мельница: мельницы
место: место
мечеть: мечетей мечети
мила: мил
министерство: министерства министерство
минниханов: миннихановым
минобрнауки: минобрнауки
мир: мир
младший: младший
многие: многие
многий: многих
многоквартирный: многоквартирные
многолетний: многолетней многолетний многолетнюю
множество: множества
мобильный: мобильная
моделирование: моделирования
молодой: молодой
море: моря
мост: мосты
мочь: могут
музей: музей
музейный: музейные
муслюмовский: муслюмовский
мусульманин: мусульман
муфтий: муфтиев
мы: нами
мэлт: мэлт
н: н
навигация: навигации навигация
награда: наградами награды
наградить: награжден награждён награждённые
награждение: награждении
нагрудный: нагрудный нагрудным
надыров: надырова
назначить: назначен
направление: направлению
наследие: наследия
наследство: наследству
натурный: натурного
наука: наук науке науки
научный: научная научный научным
начало: начала
начальник: начальником
наш: наших
некоммерческий: некоммерческой
некоторый: некоторые
неоднократно: неоднократно
неопр: неопр
непритязательный: непритязательно
николаевич: николаевна
нк: нк
нн: нн
новый: новые
ноябрь: ноября
нужный: нужна
нынешний: нынешним
область: области
облик: облика
образование: образования
обращение: обращения
обсуждение: обсуждение
обучаться: обучающихся
общественный: общественные
объект: объекта объектов
овладеть: овладел
один: одну
одновременно: одновременно
оживить: оживить
океан: океан
окончить: окончил
окрестность: окрестностей
октябрь: октября
олин: олина
ольга: ольга
омга: омга
описание: описание
организация: организации организация
основать: основал
оставлять: оставлял
ответ: ответом
ответственность: ответственности
отдельный: отдельной отдельных
отец: отец
отечественный: отечественной
отказ: отказ
открытка: открыткам
отличаться: отличается
отличие: отличие
отредактировать: отредактирована
официальный: официальный
ошибка: ошибке
п: п
павильон: павильонами
память: память
парка: парки
пашинцев: пашинцева
педагог: педагоги
пейзаж: пейзаж
пейзажист: пейзажисты
первый: первых
передача: передачей
переехать: переехал
переиздать: переиздана
перейти: перейти
персоналия: персоналии
персональный: персональные персональных
печать: печати печать
плодотворный: плодотворную плодотворный
площадь: площади
поведение: поведения
поддерживать: поддерживает
подробный: подробнее
поездка: поездок
пожениться: поженились
пожертвовать: пожертвовать
познакомиться: познакомились
поиск: поиск поиску
политика: политика
половина: половины
получить: получив получил получить
портал: портал
портрет: портрет
последний: последний
пособие: пособие
пост: пост
постоянный: постоянная
построить: построенных
поступить: поступил
почётный: почетное почётного почётное
поэтому: поэтому
правдивость: правдивостью
править: править
правка: правки
правовой: правовой
предмет: предметов
предпринять: предпринял
представиться: представились
президент: президент президента президентом
преимущественно: преимущественно
премия: премии премию
преподаватель: преподавателей преподаватели
преподавать: преподаёт
привести: приведет
признание: признание
приказ: приказ
примечание: примечания
принимать: принимал
приостановить: приостановил
природный: природный
присвоение: присвоении
присвоить: присвоено
программа: программе
проект: проектах
проектный: проектно
прокофьев: прокофьев прокофьева
проникновение: проникновением
проникновенность: проникновенностью
пропорция: пропорций
просмотр: просмотры
проспект: проспекте
просто: просто
простор: просторы
пространственный: пространственная
пространство: пространства пространство
профессия: профессии
профессор: профессор профессора профессором профессору
путешествие: путешествия
путь: пути
р: р
работа: работ работу работы
работать: работает работал
работник: работник работника работники
равил: равил
равиль: равиль равиля
развитие: развитие
раздор: раздору
различный: различными различных
разработчик: разработчики
район: район района районы
районнары: районнары
распоряжение: распоряжение
рг: рг
результат: результатом
рен: рен рене
республика: республика республики
ресторан: рестораны
ресурс: ресурсы
речной: речные
решение: решения
ри: ри
рисование: рисованием
рисовать: рисует
рисунок: рисунка рисунке рисунок
рл: рл
родиться: род родившиеся родился
рождение: рождения
российский: российский российской
россия: россии россия
рсфср: рсфср
рт: рт
рубеж: рубежом
руководитель: руководитель
руководство: руководством
руслан: руслан
русский: русские русский русских русского
русый: рус
ручка: ручек
рыбный: рыбно
ряд: ряд ряда
саба: саба
сабинский: сабинский
савиново: савиново
сад: сады
сайт: сайт
сайяр: сайяр сайяра
сайярович: сайярович
саксофон: саксофоне
самовар: самоваров
самореализация: самореализации
самый: самую
саярович: саярович
сведение: сведения
свежий: свежие
светлана: светлана
свияжска: свияжска
свобода: свободы
свободный: свободной
своеобразный: своеобразный
свой: свои своими своём
свойство: свойство
связанный: связанные
связаться: свяжитесь
связь: связи
секрет: секретом
село: сёл сёлам
сельский: сельского
семь: семи
семья: семьёй
сентябрь: сентября
серия: серия
сидоров: сидорова
сие: се
система: системе
ситдикович: ситдикович
скачать: скачать
скрытый: скрытые
слить: слим
слободский: слободский
слово: словам
сложный: сложным
служебный: служебные служебных
случай: случаях
случайный: случайная
сменить: сменив
смотреть: см
соавторство: соавторстве
собор: соборов
собрать: собрав
собственный: собственной
событие: события
совет: совета
советский: советский
современник: современников
современный: современного
содержание: содержание
создать: создал создать
соискание: соискание
сообщество: сообщество
сообщить: сообщить
сор: сора
сосредоточиться: сосредоточившись
состояться: состоялся
сохранение: сохранение сохранением
сохраниться: сохранившимся
сочетание: сочетаниях
союз: союза
спориуса: спориуса
справка: справка
среди: среди
средиземный: средиземное
средний: среднюю
сс: ссам
ссср: ссср
ссылка: ссылка ссылки
старый: старая старой
статистика: статистика
статуя: статуя
стать: став стал стала стали
статья: статьи статья
степень: степень
стоять: стоявший
страна: страна
страница: страница странице страницу страницы
строгий: строгих
строитель: строитель
строительный: строительного строительный
студент: студентов
сфера: сфера сферу
считать: считает считая
сша: сша
сын: сын
сыроварня: сыроварни
сюда: сюда
тази: тази
так: т
также: также
тат: тат
татарин: татар
татарский: татарская татарских
татарстан: татарстан татарстана
татарча: татарча
татьяна: татьяна
творчески: творчески
творческий: творческий творческих творческой творческую
творчество: творчестве
текст: текст
текущий: текущей текущие
тема: тему
техник: техниками
тип: типов
товарный: товарный
тонкий: тонкой
торговый: торгового
тот: той
точный: точной точным
традиция: традиций
труд: труд
тукаевский: тукаевскую
тукать: тукая
турция: турции
убранство: убранства
уважать: уважают
увидеть: увидим
увлекаться: увлекался
уделять: уделяет
удостоить: удостоен
указ: указ
указание: указанием
указать: указан
украсить: украсила
улица: улиц улицам
улы: улы
университет: университет университета
уничтожение: уничтожения
управление: управления
урамнарында: урамнарында
урбанистика: урбанистики
урожд: урожд
условие: условий условия условиях
успех: успеха
участвовать: участвовал
участие: участие
учебный: учебное
учитель: учителями
учёба: учёбы
учёный: ученых учёная учёное учёную учёные
учётный: учётную
ф: ф
факт: факты
факультет: факультет
фамилия: фамилией
фарид: фарид фарида
фаузия: фаузия
федерация: федерации
физика: физикой
филиал: филиале
фонд: фонд
форум: форум
фотографирование: фотографированием
фотофиксация: фотофиксацией
франция: франции
ханиф: ханифа
хис: хис
хроника: хроники
художественный: художественной
художник: художник художника художники художников художником
хусаин: хусаина
хусаинович: хусаиновна
цветовой: цветовых
цель: целях
центр: центра
церемония: церемонии
цитировать: цитировать
часть: части
человек: людях человек
человеческий: человеческого
читать: читать
член: членом
чёрно: чёрно
чёрный: чёрное
шагидуллин: шагидуллин
швейный: швейных
широта: ш
школа: школе школу
эгейский: эгейское
экспедиция: экспедиций
экспозиция: экспозиций
экспорт: экспорт
элемент: элемент
энциклопедия: энциклопедии
эпоха: эпохи
эстрада: эстрадами
этнографический: этнографический
этот: эта
эшл: эшл
являться: является являлся
язык: язык языках
ямашева: ямашева
январь: января
ярмарочный: ярмарочные
