авангард: авангарда
август: августа
авт: авт
автор: автор
авторство: авторства
акварель: акварель
александр: александр
алпатов: алпатов
алфавит: алфавиту
альбом: альбомам
ани: ани
анисимов: анисимов
анисимович: анисимович
апшерон: апшерона
архивировать: архивировано
атташе: атташе
баку: баку
беспредельный: беспредельный
бизнессофт: бизнессофт
биографический: биографическая
биография: биографии биография
бог: бог
больший: большая
варфоломей: варфоломея
вд: вд
век: века
версия: версия
викидать: викиданных
викимедиа: викимедиа
википедия: википедии википедия
викитека: викитеку
вклад: вклад
военнослужащий: военнослужащего
войти: войти
волшебный: волшебные
восторг: восторг
врубель: врубеля
вступа: вступ
выпускник: выпускники
выст: выст
выставка: выставках
г: г
газета: газета газетах газеты
галерея: галерея
год: года годов году годы лет
государственный: государственными
гражданство: гражданство
григо: григо
григорий: григорий
гянджлик: гянджлик
дата: дата
действовать: действовать
деятель: деятели деятель
деятельность: деятельности
добавить: добавить
дополнительный: дополнительные
доступный: доступен
другой: других
дружить: дружил
евгений: евгения
ещё: ещё
живой: живые
живописный: живописное
живопись: живописью
журналист: журналисты
журналистика: журналистики
заглавный: заглавная
заниматься: занимался
занятие: занятий
запись: запись
зарегистрировать: зарегистрированный
заслуга: заслуги
заслужить: заслуженные заслуженный
заявление: заявление
знак: знак
значение: значение
золотой: золотая золотой
иддк: иддк
иж: иж
избранный: избранные
издание: издание
издатель: издатель
изображение: изображений
изобразительный: изобразительного
имя: имени имён
институт: института
инструмент: инструменты
исаак: исаак
искусство: искусств искусства
искусствовед: искусствовед искусствоведы
использование: использования
использовать: использующие
исследователь: исследователи
история: история
источник: источник
иткинд: иткинд
июль: июля
июнь: июня
казимир: казимире
кат: кат
каталог: каталоги
категория: категории
квасов: квасов
киевский: киевского
клуб: клуба
книга: книг
кну: кну
код: код
кодекс: кодекс
коллекционер: коллекционер
комсомолец: комсомолец
конфиденциальность: конфиденциальности
короткий: короткий
который: которым
краска: краски
критик: критик
критика: критики
кук: куки
культура: культура
кумир: кумир
лир: лира
литературный: литературная литературной литературные литературный
лицензия: лицензии
м: м
малевич: малевиче
малевичевед: малевичеведы
март: марта
мастерство: мастерство
матвеев: матвееве
материал: материал
медаль: медаль
место: место
мир: мира
мобильный: мобильная
мой: моем
москва: москва москве
московский: московская московский
мочь: могут
мусагет: мусагет
мусагетъ: мусагетъ
мы: нами
навигация: навигации навигация
награда: наградами награды
награждение: награждении
незаконченный: незаконченные
некоммерческий: некоммерческой
неопр: неопр
непустой: непустое
новый: новые
область: области
образование: образование
обращение: обращения
обсуждение: обсуждение
окончить: окончил
октябрь: октября
описание: описание
организация: организации
оригинал: оригинала
ответственность: ответственности
отдельный: отдельных
отказ: отказ
отредактировать: отредактирована
ошибка: ошибке
пен: пен
перейти: перейти
периодически: периодически
персоналия: персоналии
персональный: персональные
печататься: печатался
печать: печати печать
писатель: писатели писатель писателях
поведение: поведения
поверженный: поверженный
повесть: повесть
подробный: подробнее
пожертвовать: пожертвовать
поиск: поиск поиску
политика: политика
получить: получить
последний: последний
постоянный: постоянная
правда: правда
править: править
правка: правки
предисл: предисл
предисловие: предисловий
представиться: представились
президент: президента
пресс: пресс
признание: признание
примечание: примечания
проект: проектах
прозаик: прозаик
произведение: произведений
просмотр: просмотры
пространство: пространства
пушкин: пушкина пушкине
пушкинский: пушкинская
работа: работы
работать: работал
разработчик: разработчики
рассказ: рассказы
расти: рос
растрелли: растрелли
рецензия: рецензий
рий: рий
рисунок: рисунок
рнб: рнб
родиться: род родившиеся родился
рождение: рождения
роман: роман
российский: российский российской
россия: россии россия
рсфср: рсфср
рука: рук
русский: русская русский русского
сведение: сведения
свежий: свежие
свободный: свободной
свой: своего
связанный: связанные
связаться: свяжитесь
семья: семье
сим: симов
симович: симович
система: системе
скачать: скачать
скрытый: скрытые
скульптор: скульпторах
скульптура: скульптура
служебный: служебные
случай: случаях
случайный: случайная
смерть: смерти
смотреть: см
собирать: собирал
событие: события
сова: сов
советский: советская
содержание: содержание
создать: создать
сообщество: сообщество
сообщить: сообщить
сост: сост
сотрудник: сотрудники
сохранение: сохранением
сочинение: сочинения
союз: союза
справка: справка
сср: сср
ссср: ссср
ссылка: ссылка ссылки
ст: ст
статистика: статистика
стать: статей
статья: статьи статья
страница: страница странице страницу страницы
сюда: сюда
так: т
также: также
творчество: творчества творчество
текст: текст
текущий: текущие
тип: тип
товарный: товарный
ты: тебе
указ: указ
указание: указанием
украинский: украинская
умерший: умершие
университет: университета
условие: условий условия
участвовать: участвовал
участие: участие
учётный: учётную
факультет: факультет
фамилия: фамилией
фасад: фасад
федерация: федерации
фонд: фонд
форум: форум
х: х
харьков: харьков харькове
хроника: хроника
худож: худож
художественный: художественным
художество: художества
художник: художник художниках художники художников
центр: центра
цитировать: цитировать
человек: людях человек
читать: читать
член: член члены
чубаров: чубарова
шаблон: шаблон
экз: экз
экспорт: экспорт
электронный: электронное электронные
элемент: элемент
энциклопедия: энциклопедии энциклопедия
этот: эта
язык: язык языках
яковлевич: яковлевич
январь: января
