абстракция: абстракции
австралия: австралии
автограф: автограф
автор: автор автором
авторитетный: авторитетная
авторство: авторства
академик: академик
академия: академии академия
алфавит: алфавиту
америка: америки
англ: англ
андерл: андерле
антонин: антонина
апрель: апреля
архив: архив
архивировать: архивировано
ассистент: ассистент
африка: африки
база: база
бероун: бероун
библиографический: библиографических
биеннале: биеннале
биография: биографии биография
будничный: будничная
бытие: бытия
век: века
версия: версия
викидать: викиданных
викимедиа: викимедиа
википедия: википедии википедия
викисклад: викисклад викискладе
вклад: вклад
владимир: владимира
внешний: внешние
войти: войти
время: время
всё: всё
выпуск: выпуска
высокий: высшая высшей высшую
выставка: выставки
выступать: выступавших
выступить: выступил
выходить: выходивших
выходной: выходным
год: года годах году лет
гравёр: гравёр
гран: гран
график: график графику
графика: графика графики
графический: графический графических
данные: данных
дата: дата
два: двух
действовать: действовать
деятель: деятели
деятельность: деятельности
дизайнер: дизайнер
дополнительный: дополнительного дополнительные
доступный: доступен
другой: других
европа: европа европы
ещё: ещё
жанр: жанр
живопись: живопись
жорж: жоржа
завоевать: завоевал
заглавный: заглавная
заменить: заменить
запись: запись
зарегистрировать: зарегистрированный
заслуга: заслуги
затем: затем
заявление: заявление
зденек: зденека
знак: знак
играть: играл
избранный: избранные
известный: известные
изображение: изображение
изобразительный: изобразительного изобразительных
изучать: изучал
имя: имён
инструмент: инструментах инструменты
иржи: иржи
искусство: искусств искусства
использование: использования
история: история
источник: источник источниками
йоркский: йоркский
картина: картины
каталог: каталогах
категория: категории
класс: классе
код: код
кодекс: кодекс
коллектив: коллективов
конфиденциальность: конфиденциальности
короткий: короткий
край: крае
крупный: крупнейших
кук: куки
лицензия: лицензии
люблян: любляне
май: мая
марк: марка
марка: марки марок
мастерская: мастерская
материал: материал
медаль: медалью
медиафайл: медиафайлы
международный: международной
место: место
метрополитен: метрополитен
мир: мира
многий: многих
мобильный: мобильная
мочь: могут
музей: музей музеях
музыкальный: музыкальных
мы: нами
навигация: навигации навигация
награда: награды
наградить: награждён награждённые
национальный: национальная
некоммерческий: некоммерческой
немой: нем
несчастливый: несчастливыми
новый: новые
нп: нп
нью: нью
обращение: обращения
обстоятельство: обстоятельствами
обсуждение: обсуждение
обучаться: обучался
обучение: обучение
одиночество: одиночество
окончить: окончил
октябрь: октября
описание: описание
организация: организации
ответственность: ответственности
отдельный: отдельных
отказ: отказ
отразить: отражены
отредактировать: отредактирована
ошибка: ошибке
павликов: павликов
парижский: парижский
пелец: пельца
передаваться: передаётся
перейти: перейти
персоналия: персоналии
персональный: персональные
печать: печати печать
поведение: поведения
подробный: подробнее
пожертвовать: пожертвовать
поиск: поиск поиску
политика: политика
полотно: полотнах
получить: получить
помпида: помпиду
посетить: посетил
последний: последнее последний
посредством: посредством
постоянный: постоянная
поступить: поступил
почтовый: почтовые почтовых
править: править
правка: правки
прага: прага
пражский: пражской пражскую
представиться: представились
прикладной: прикладного
примечание: примечания
проект: проектах
произведение: произведений
пройти: прошли
просмотр: просмотры
пространство: пространства
псевдоним: псевдонимами псевдонимы
работа: работах
работать: работал
различный: различные
разработчик: разработчики
район: район районах
раковникнуть: раковник
рамка: рамках
ресурс: ресурсы
рисунок: рисунков
родиться: род родившиеся
рождение: рождения
руководство: руководством
русский: русский
сайт: сайт сайты
сведение: сведения
свежий: свежие
сверхвременной: сверхвременная
свободный: свободной
связанный: связанные
связать: связанная
связаться: свяжитесь
сентябрь: сентября
силовский: силовского
система: системе
скачать: скачать
скленаржа: скленаржа
скрытый: скрытые
словарь: словари
служебный: служебные
случай: случаях
случайный: случайная
смотреть: см
событие: события
совместный: совместного
современник: современников
современный: современные современный
содержание: содержание
создать: создать
сообщество: сообщество
сообщить: сообщить
состав: составе
сохранение: сохранением
справка: справка
среднечешский: среднечешском
ссылка: ссылка ссылками ссылки
старость: старость
статистика: статистика
статья: статьи статья
степень: степени
страна: страна странах страны
страница: страница странице страницу страницы
сюда: сюда
такой: таких
танец: танцах
творчество: творчество
театральный: театральным
текст: текст текста
текущий: текущие
тематический: тематические
товарный: товарный
трагедия: трагедия
трагичность: трагичности
трнка: трнки
ударный: ударных
указание: указанием
условие: условий условия
успех: успехом
участие: участие
учёба: учёба
учётный: учётную
фонд: фонд
форум: форум
хорватский: хорватская
художественный: художественная
художник: художник художника художники художником
центр: центр
цитировать: цитировать
человек: человека
чехия: чехии чехия
чехословакия: чехословакии чехословакия
чеш: чеш
чешский: чешская чешский чешских чешской
число: числе
читать: читать
шаблон: шаблоном
школа: школа школе школу
экзистенциальный: экзистенциальная
экспорт: экспорт
элемент: элемент
энциклопедия: энциклопедии
эскиз: эскиза
эстамп: эстамп эстампов
этот: эта
язык: языках
январь: января
