автор: автор
авторство: авторства
академия: академии
алфавит: алфавиту
альбом: альбома
ампилов: ампилов
ассоциация: ассоциации
бакалавриат: бакалавриата
бг: бг
биография: биографии биография
благодарность: благодарность
болгария: болгария
большой: большой
быть: е
ввц: ввц
ведущий: ведущий
век: века
версия: версия
вестник: вестник
викидать: викиданных
викимедиа: викимедиа
википедия: википедии википедия
вклад: вклад
владимир: владимир
внедрение: внедрение
водомётный: водомётного
войти: войти
выпускник: выпускники
высокий: высшее
выставочный: выставочных
вэп: вэп
г: г
год: года году лет
гпи: гпи
гуманитарный: гуманитарно
далее: д
дата: дата
два: двух
действовать: действовать
декоративный: декоративное
деятель: деятели
деятельность: деятельности деятельность
джет: джет
дизайн: дизайн дизайна дизайне дизайну
дизайнер: дизайнеров
добавить: добавить
доблесть: доблесть
дополнительный: дополнительные
достижение: достижения
доступный: доступен
доцент: доцент
другой: других
ещё: ещё
жилой: жилых
жить: живёт
журнал: журнале
заведовать: заведующего
заглавный: заглавная
занятие: занятий
зао: зао
запись: запись
зарегистрировать: зарегистрированный
заявление: заявление
звание: звания
знак: знак
иванович: иванович
идея: идеи идей
избранный: избранные
избрать: избран
издание: издании
изображение: изображений
изобразительный: изобразительного
имя: имени имён
институт: институте
инструмент: инструменты
интерьер: интерьера интерьеров
искусство: искусства искусство
исполнять: исполняющий
использование: использования
история: история
источник: источник
итог: итогам
канал: канале
категория: категории
катер: катера
кафедра: кафедре кафедрой кафедры
код: код
кодекс: кодекс
коллективный: коллективная
комплекс: комплекс
композиционный: композиционных
конмета: конмет
конструирование: конструирование
конференция: конференций
конфиденциальность: конфиденциальности
координационный: координационного
короткевич: короткевич
короткий: короткий
корреспондент: корреспондент корреспондентом корреспонденты
кракиновский: кракиновской
краснодар: краснодаре
кук: куки
лауреат: лауреат
легенда: легенды
лицензия: лицензии
марин: марин
март: марта
материал: материал
мвхп: мвхпу
мгхп: мгхпа
мебель: мебели
медаль: медаль медалью
международный: международной
методический: методический
миф: мифы
моа: моа
мобильный: мобильная мобильных
модуль: модулей
монография: монография
москва: москва москве
московский: московское
мочь: могут
мы: нами
мэи: мэи
навигация: навигации навигация
награда: награды
наградить: награждённые
наручный: наручных
научно: научно
научный: научная
некоммерческий: некоммерческой
неопр: неопр
ниу: ниу
новый: новые
оао: оао
область: области
обращение: обращения
обсуждение: обсуждение
общественный: общественная общественной общественных
обязанность: обязанности
окончить: окончил
октябрь: октября
описание: описание
опыт: опыт
организация: организации организация
основной: основные
ответственность: ответственности
отделение: отделения
отдельный: отдельных
отказ: отказ
отредактировать: отредактирована
ошибка: ошибке
п: п
павлюк: павлюк
педагогический: педагогическая
перейти: перейти
персоналия: персоналии
персональный: персональные
печать: печати печать
поведение: поведения
подробный: подробнее
пожертвовать: пожертвовать
поиск: поиск поиску
политика: политика
получить: получить
последний: последний
пособие: пособий
постоянный: постоянная
почёт: почёта
править: править
правка: правки
предметно: предметно
представительство: представительств
представиться: представились
представление: представления
преподаватель: преподаватели преподаватель
прибор: приборов
прикладной: прикладном
прилегать: прилегающей
программа: программы
проект: проекта проектах проектов проекты
проектирование: проектирование проектирования
проектный: проектной
промышленный: промышленного промышленное промышленных
просмотр: просмотры
пространственный: пространственная
пространство: пространства
профиль: профиль
работать: работает
рабочий: рабочей
развитие: развитие
разработка: разработка разработку
разработчик: разработчики
рах: рах
реализация: реализации реализацию
реальность: реальность
родиться: род родившиеся родился
рождение: рождения
российский: российский российского российской
россия: россии россия
руководитель: руководитель
руководство: руководством
русский: русский
сведение: сведения
свежий: свежие
свободный: свободной
связанный: связанные
связаться: свяжитесь
секция: секции
серебряный: серебряная
сибел: сибел
система: системе
скачать: скачать
скоростной: скоростного
скрытый: скрытые
слава: слава
служебный: служебные
случай: случаях
случайный: случайная
смотреть: см
событие: события
совет: совета
советский: советский
современник: современников
содержание: содержание
создание: создание созданию
создать: создать
сообщество: сообщество
сообщить: сообщить
сохранение: сохранением
союз: союз союза
специальность: специальности
справка: справка
среда: среда среды
средова: средовой
средство: средств
ссср: ссср
ссылка: ссылка ссылки ссылок
статистика: статистика
стать: статей
статья: статьи статья
страна: страна
страница: страница странице страницу страницы
строганов: строганова
строгановский: строгановское
сюда: сюда
татлина: татлина
творческий: творческая творческого
текст: текст
текущий: текущие
территория: территории
тип: тип
товарный: товарный
тойфелена: тойфелен
транспортный: транспортных
трудовой: трудовую
тула: туле
указание: указанием
условие: условий условия
участие: участие
учебный: учебных
училище: училище
учёба: учёба
учётный: учётную
фабрика: фабрики
фгос: фгос
фио: фио
фонд: фонд
формирование: формирование
форум: форум
хабаровск: хабаровске
хроника: хроники
художественно: художественно
художественный: художественное
художество: художеств
художник: художник художники художников
цитировать: цитировать
час: часов
часть: часть
человек: человек
читать: читать
член: член членом члены
шаблон: шаблоном
швейцария: швейцария
шувалов: шувалов
шуперботс: шуперботс
экспозиция: экспозиций
экспорт: экспорт
экстерьер: экстерьера экстерьеров
электродвигатель: электродвигателем
электронный: электронных
элемент: элемент
энциклопедия: энциклопедии
этот: эта
язык: языках
