август: августа
австро: австро
автор: автор
авторство: авторства
академический: академического академическом
академия: академии академию
акварель: акварелей
алфавит: алфавиту
ангел: ангелов
апрель: апреля
баварский: баварскую
база: базе
балканский: балканских
белград: белграде
биография: биография
благожелательно: благожелательно
бог: бог
болга: болг
болгария: болгарии болгарию болгария
болгарский: болгарский болгарских болгарского болгарской
большой: большого велико
бреница: бреница
буря: буря
български: български
быт: быт
варна: варны
век: века
великий: великих
вена: вене
венгрия: венгрии
вернуться: вернулся
версия: версия
веяльщица: веяльщица
взять: взял
викидать: викиданных
викимедиа: викимедиа
википедия: википедии википедия
викисклад: викисклад викискладе
вклад: вклад
войти: войти
встретить: встреченные
второй: вторая второй
выставка: выставка выставке выставкой
год: год года году годы лет
гора: гор
график: график
графика: графики
дата: дат дата
дать: дал
действовать: действовать
день: дня
деятель: деятели
деятельность: деятельности
димитров: димитрова
директор: директора
дополнительный: дополнительные
доступный: доступен
др: др
другой: других
ежегодный: ежегодное
ещё: ещё
жанровый: жанровые жанровых
жатва: жатва
живопись: живописи живопись
жнец: жнецы
жница: жница
завершение: завершения
заглавный: заглавная
загреб: загребе
занятие: занятий
запись: запись
зарегистрировать: зарегистрированный
затем: затем
заявление: заявление
знак: знак
знакомиться: знакомится
значение: значение
золотой: золотой
иван: иван ивана
избранный: избранные
известный: известный
издание: издание
изображение: изображений
изобразительный: изобразительного
изучать: изучает
изящный: изящных
иллюстрировать: иллюстрированное
империя: империя
имя: имени имя имён
индустриальный: индустриальное
инициатор: инициаторов
инструмент: инструменты
искусство: искусств искусства
использование: использования
история: история
источник: источник
италия: италию
итальянский: итальянских
календарь: календарь
карла: карла
картина: картин картина картины
категория: категории
код: код
кодекс: кодекс
конфиденциальность: конфиденциальности
королевский: королевскую
короткий: короткий
косарь: косарь
крестьянин: крестьян
крестьянский: крестьянской
критический: критического
кук: куки
ливад: ливада
литература: литература
лицензия: лицензии
лондон: лондоне
м: м
мастер: мастеров
материал: материал
медаль: медали
медиафайл: медиафайлы
международный: международной
место: место
многий: многих
мобильный: мобильная
мочь: могут
мы: нами
мюнхен: мюнхене
мюнхенский: мюнхенской
навигация: навигации навигация
направление: направления
начальный: начальное
начинать: начинает
небо: небе
некоммерческий: некоммерческой
немецкий: немецкой
непустой: непустое
новый: новые
ноябрь: ноября
ныне: ныне
область: области
образование: образование образования
обсуждение: обсуждение
общественность: общественностью
общество: общества
один: одним
окончание: окончания
описание: описание
организация: организации
освобождение: освобождения
осиека: осиеке
османский: османская
основатель: основатель
основный: основная
ответственность: ответственности
отдельный: отдельных
отдых: отдых
отказ: отказ
откуда: откуда
отправляться: отправляется
отредактировать: отредактирована
отчество: отчеству
ошибка: ошибке
памятный: памятных
педагог: педагог педагоги
пейзаж: пейзаж пейзажей
пейзажист: пейзажисты
первый: первая первой
перейти: перейти перешёл
персона: персона
персоналия: персоналии
персональный: персональная персональные
печать: печати печать
пилот: пилота
плевенский: плевенской
пловдив: пловдива
пловдивский: пловдивской
поведение: поведения
подготовка: подготовку
подданство: подданство
подробный: подробнее
пожертвовать: пожертвовать
поиск: поиск поиску
показать: показал
политика: политика
получить: получил получить
портрет: портретов
портретист: портретисты
последний: последний
постоянный: постоянная
править: править
правка: правки
предгорие: предгорьях
представитель: представителя
представить: представил
представиться: представились
прекрасный: прекрасную
преобразование: преобразования
преподаватель: преподавателем
преподавать: преподавал преподавать
привести: привели
прикладной: прикладное
принять: принял
продолжить: продолжил
проект: проектах
произведение: произведениями
просмотр: просмотры
пространство: пространства
профессор: профессор профессора
работа: работы
разработчик: разработчики
реализм: реализма
рисовальный: рисовальном
рисование: рисованию рисования
рисунок: рисунке рисунков рисунок
родиться: род родившиеся родился
рождение: рождении рождения
роза: роз
руководство: руководством
русский: русский
ряд: ряда
сборщица: сборщица
сведение: сведения
свежий: свежие
свободный: свободной
свой: своей свои
связанный: связанные
связаться: свяжитесь
село: селе
семья: семье
сердце: сердце
серия: серию
система: системе
скачать: скачать
скрытый: скрытые
сливен: сливена
служебный: служебные
случай: случаях
случайный: случайная
смерть: смерти
смотреть: см
снова: снова
событие: события
современный: современных
содержание: содержание
создание: создания
создать: создать
сообщество: сообщество
сообщить: сообщить
состояться: состоялась
софийский: софийском
софия: софии софия
сохранение: сохранением
способность: способности
справка: справка
ссылка: ссылка ссылки
статистика: статистика
статья: статьи статья
сто: сто
стоян: стоянов
страница: страница странице страницу страницы
сюда: сюда
творчество: творчества творчество
текст: текст
текущий: текущие
тема: тема
территория: территории
течение: течение
тип: тип
товарный: товарный
тот: те
труд: труд
трудиться: трудился
турок: турок
тырново: тырнове тырново
удостоить: удостоена
указание: указанием
умерший: умершие
условие: условий условия
участие: участие
училище: училища училище
учёба: учёбу
учётный: учётную
фамилия: фамилией
флоренция: флоренции
фонд: фонд
форум: форум
художественно: художественно
художественный: художественного художественной художественный
художество: художеств
художник: художник художники художников
цель: целью
цитировать: цитировать
человек: людях человек
число: числа
читать: читать
шаблон: шаблон
школа: школах школе школы
экспонироваться: экспонировавшаяся экспонировались
экспорт: экспорт
элемент: элемент
энциклопедия: энциклопедии
этот: эта
южнославянский: южнославянской
язык: языках
ярмарка: ярмарке
