абанотубань: абанотубани
авангард: авангард
авангардист: авангардисты
август: августа августе
аверс: аверс
аврора: аврора
автандил: автандил
автограф: автограф
авторство: авторства
аз: аза
активно: активно
актриса: актриса актрисе актрисы
актёр: актёр
александр: александр александра
алла: аллы
алугишвили: алугишвили
алфавит: алфавиту
алый: алых
альбом: альбом
амашукель: амашукели
амиран: амиран
англ: англ
андрей: андрей андрея
аникст: аникст
анималистический: анималистические
ансамбль: ансамбли
антокольский: антокольский
антон: антон
апрель: апреля
апчинскай: апчинская
апчинский: апчинской
арабеска: арабески
аргумент: аргументами
армянский: армянских
арх: арх
архивировать: архивировано
архивный: архивная
асатиани: асатиани
асл: асла
аслан: аслан
асланович: асланович
б: б
бархин: бархин
басилай: басилая
батум: батум
батуми: батуми
баш: баш
бедняк: бедняков
бежанович: бежанович
беларускать: беларуская
белые: белые
белый: белая белого белую белый
бесплатно: бесплатно
библиографический: библиографических
биогра: биогр
биограф: биограф
биографический: биографическая биографический
биография: биографии биография
близкий: близкие
богемский: богемская
боевой: боевое
болезнь: болезни
больница: больницу
больший: большая большую
большинство: большинство
большой: большого большое большой
бороздка: бороздками
брат: брат братья
бродить: бродил
брэ: брэ
буачидзе: буачидзе
булат: булат
български: български
бывший: бывшая
бык: быком
быстро: быстро
быть: е
вадим: вадим вадима
важа: важа
вал: валу
валериан: валериан
варази: варази
ввести: введён
ведущий: ведущий
век: века
великолепный: великолепны
вернуться: вернувшийся
вероятно: вероятно
версия: версии версия
вещественный: вещественных
видеть: видеть
викидать: викиданных
викимедиа: викимедиа
викиновость: викиновости
википедия: википедии википедия
викисклад: викисклад викискладе
вино: вин
вирджиния: вирджинию
вит: вита
вклад: вклад
вложить: вложил
влюбиться: влюбился
вместе: вместе
внешний: внешние
вновь: вновь
вода: водой
возвращаться: возвращался
воздушный: воздушным
вознесенский: вознесенский вознесенского
возраст: возрасте
война: войны
войти: войти
волшебный: волшебные
воспеть: воспела
восстановить: восстановлены
восток: востока
время: времени время
вскоре: вскоре
вспоминать: вспоминал
вступительный: вступительная
всякий: всякой
всё: всё
входить: входит
вывеска: вывеска вывесках вывески вывеску вывесок
выдавать: выдавал
вып: вып
выполнить: выполнены выполнил выполнили
выполнять: выполнял
выпуск: выпуски
вырабатываться: вырабатывавшаяся
высоко: высоко
выставить: выставлены
выставка: выставка выставки
выходной: выходное
г: г
газета: газете
галерея: галерее галереи галерея
гарановый: гаранова
гвардия: гвардия
гвердцитель: гвердцители
георгий: георгием георгий
германия: германии
гиг: гига
гигаури: гигаури
гиго: гиго
гл: гл
глава: глава
главный: главную
глаз: глаза
год: года годов году годы лет
голод: голода
гончаров: гончаровой
город: город городу
господин: господ
государственный: государственного государственном государственный
гражданство: гражданство
график: график
григорий: григорий
гроб: гроб
груз: груз
грузински: грузински
грузинский: грузинские грузинский грузинских грузинской
грузия: грузии грузия
губерния: губерния
гудиашвили: гудиашвили
гумно: гумно
гуржий: гуржий
давид: давид давида
далее: д
далёкий: далекие
данть: дантю
дарить: дарил
дарсавелидзе: дарсавелидзе
дата: дата
дать: дал
два: две двух
дворник: дворник
дворянин: дворян
де: де
девочка: девочка
девятилетний: девятилетнем
дед: деда
дедоплисцкаройский: дедоплисцкаройском
действительность: действительности
действовать: действовать
декабрь: декабря
декоративный: декоративной декоративные
дело: дело
демихов: демихова
день: день дня
десница: десница
десятилетие: десятилетие
детский: детская
дешёвый: дешёвом
деятель: деятеля
деятельность: деятельности
димитра: димитрой
династия: династия
дмитрий: дмитрий
дмитровка: дмитровке
дойти: дошли
документально: документально
документальный: документальных
долгий: долгое
должный: должен
дом: дом дома доме дому
допоздна: допоздна
дополнительный: дополнительные
дорога: дороге
достигаться: достигается
достояние: достоянии
доступный: доступен
доход: дохода
дочь: дочь
др: др
драматический: драматического
дрова: дров
друг: друг друга
другой: другая другие других
духан: духанах духане духанов
егор: егор
единственный: единственном единственный
ездить: ездил
екатерина: екатерина
екатеринбург: екатеринбург
ещё: ещё
её: её
жанна: жанна
жанр: жанр
желание: желанию
железа: железе
железный: железной
желтизна: желтизна
живописец: живописец
живописный: живописных
живопись: живописи живопись живописью
животное: животные животных
жизнеописание: жизнеописание жизнеописания
жизнь: жизни жизнь
жираф: жираф
жить: живёт жил жить
журнал: журнал
заблуждение: заблуждение
заведение: заведений
заглавие: заглавием
заглавный: заглавная
зазиашвили: зазиашвили
заинтересоваться: заинтересовались
закавказский: закавказская закавказский
закавказье: закавказье
заказ: заказ заказов
закатать: закатала
закон: закон
закончить: закончил
заметить: заметили
замечательный: замечательных
замечать: замечал
занимать: занимают
заниматься: занимался
занятие: занятия
запись: запись
заполнить: заполнить
зарабатывать: зарабатывать
зарегистрировать: зарегистрированный
заслужить: заслуженного заслужил
захава: захавы
заявление: заявление
зданевич: зданевич зданевича зданевичем зданевичи
здравствуйте: здравствуйте
знак: знак знаком
знаменитый: знаменитая
знать: знаю
значение: значения
значительно: значительно
значительный: значительное
иверие: иверия
идти: идёт
избранница: избранницами
избранный: избранные
известие: известия
известно: известно
известный: известны известные известных
извиваться: извивающимися
изготавливать: изготавливал
изготовление: изготовление
изображение: изображениями
изобразительный: изобразительного
изобразить: изображены
илья: ильи илья ильёй
иметь: имел имела иметь
империя: империи империя
имя: именем имени имя имён
инструмент: инструменты
интерес: интереса
интересоваться: интересоваться
интернет: интернет
ирон: ирон
искусство: искусств искусства искусстве искусство
испещрить: испещрённой
исполнение: исполнении
исполнять: исполняет исполняли
использование: использования
использовать: использующие
исправлять: исправлять
исторический: исторический
история: истории история
источник: источник
итог: итоге
июль: июле июля
июнь: июня
й: й
кабан: кабан
кавказ: кавказе
каждый: каждом
какабадзе: какабадзе
какой: какого
калантаров: калантаровой калантарову калантаровым калантаровых
канделаки: канделаки
картина: картин картина картинах картины
картинный: картинная картинной
картон: картоне
каталог: каталог каталогах
категория: категории
кахетие: кахетии кахетия
квартира: квартира
кенотаф: кенотаф
кирилл: кирилл кирилла
кисть: кисть
кладбище: кладбище
классик: классик
клеёнка: клеенки клеёнка клеёнках клеёнке клеёнки
кн: кн
книга: книга книги
князь: князей
кобылянский: кобылянского
код: код
кодекс: кодекс
количество: количество
коллекция: коллекцию коллекция коллекциях
комиссариат: комиссариат
компаньон: компаньоном
кондуктор: кондуктором
конец: конца конце
конечный: конечном
константин: константин
контакт: контактов
контраст: контраст контраста
конференция: конференции
конфиденциальность: конфиденциальности
копия: копия
корова: корова
коростылёв: коростылёв коростылёва
короткий: короткий короткое
короткометражный: короткометражный
косуля: косуля
который: которого которой которую которые которым которыми
краска: краски краску
красный: красной
крестьянин: крестьянин
крестьянка: крестьянка
крестьянский: крестьянской
круг: кругу
кругосвета: кругосвет
крупный: крупнейшим крупнейших
крусанов: крусанов
крымский: крымском
кто: кем
кузнецов: кузнецов
кузьмин: кузьмин
кук: куки
кукийский: кукийском
кукла: куклы
культура: культуре
купюра: купюр купюры
кусок: куски
кутаиси: кутаиси
кутёж: кутёж
кухня: кухне
кыргызча: кыргызча
л: л
лавка: лавке лавку лавок
ладо: ладо
лань: лань
ларионов: ларионов ларионова
ларь: лари
ле: ле
легенда: легенд легенда легенде легенды
лекарь: лекарь
ленингра: ленингр
леонидзе: леонидзе
лето: летом
либо: либо
линолеум: линолеуме
литература: литература
литературный: литературное
литрес: литрес
лицевой: лицевой
лицензия: лицензии
лицо: лица
лобненский: лобненского
лордкипанидзе: лордкипанидзе
лунный: лунную
любимый: любимой
любовь: любви
лё: лё
м: м
май: мая
маленький: маленьком меньше
мальчик: мальчик
маргарита: маргарита маргарите
мариам: мариам
марк: марка
маркар: маркаров
март: марта
мастер: мастеров
мастерская: мастерской мастерскую
материал: материал материала материалом материалы
матовый: матовая
мать: мать
мегвинетухуцести: мегвинетухуцеси
медведь: медведь
медиафайл: медиафайлы
мелодия: мелодия
место: место
местонахождение: местонахождение
месяц: месяцев
микаридзе: микаридзе
миллион: миллион
мир: мира
мирзаани: мирзаани
мировой: мировой
митяев: митяева
михаил: михаил михаила
мишень: мишень
многие: многие
многое: многом
многократно: многократно
мобильный: мобильная
могила: могила могилы
молодой: молодая молодые молодых
молодость: молодости
молоканский: молоканская молоканской
молочный: молочную
монета: монеты
москаленко: москаленко
москва: москва москве
московский: московский
мочь: могут
мтацминд: мтацминда
музей: музее музеев музеи музей музея
музыка: музыка музыку
муниципальный: муниципального
мы: нами
мысль: мысль
мюзикл: мюзикл
н: н
навигация: навигации навигация
надпись: надписи
название: название
назвать: названо
наиболее: наиболее
наивный: наивного
накрывать: накрывали
напечатать: напечатал
написать: написан написана написанной написанные написаны
нарисовать: нарисовал
народ: народов
нарушение: нарушения
наряду: наряду
насидзе: насидзе
настоящий: настоящее
наталья: натальи
натюрморт: натюрморт
научиться: научился
научный: научной
находиться: находилось находятся
национальный: национальная национальной
начало: начала
начать: начал начали
невозможно: невозможно
неделя: неделе
незакрашенный: незакрашенные
нездоровый: нездоровому
неизвестно: неизвестно
некоммерческий: некоммерческой
некоторый: некоторые
немногочисленный: немногочисленные
неоднократно: неоднократно
неопр: неопр
несколько: несколько
нести: нёс
нечисловой: нечисловыми
ние: ние
ник: ника
никакой: никаких никакого
нико: нико
никола: никола
николай: николай
нищета: нищете нищеты
нович: нович
новый: нова новое новые
номинал: номиналом
носить: носит
ночевать: ночевал
ночь: ночь
ноябрь: ноября
нська: нська
нужда: нужд
нужно: нужно
нужный: нужен
ныне: ныне
обзор: обзор
обладать: обладает
обнаружить: обнаружив
обозрение: обозрение
оборотный: оборотной
образ: образы
образец: образца
образование: образования
обращение: обращения
обсуждение: обсуждение
обучение: обучении
общественный: общественном
общество: общество
общий: общая
обычно: обычно
оградить: оградить
один: одно одну
одновременно: одновременно
однодневный: однодневная
одноимённый: одноимённой одноимённые
около: около
окружающий: окружающие
октябрь: октября
окуджава: окуджава
олег: олега
олень: олень оленя
описание: описание
опубликовать: опубликовал
опытный: опытными
организация: организации
оригинальный: оригинальная
ортс: ортса
орэра: орэра
осень: осенью
осипов: осипов
основный: основная
особенный: особенного
оставлять: оставляя
остаться: остался
осёл: осле
отар: отар
отвезти: отвезли
отвергнуть: отвергнутой
ответственность: ответственности
отд: отд
отдельный: отдельные отдельных
отец: отец отца
отказ: отказ
открытие: открытия
открыть: открыл открыта
открыться: открылась
отличаться: отличаться
отмечать: отмечал
относительно: относительно
относительный: относительный
относиться: относились
отпустить: отпустил
отредактировать: отредактирована
оценивать: оценивали
очень: очень
очередь: очередь
ошибка: ошибками ошибке
оштрафовать: оштрафован
пабло: пабло
павел: павел
павлоград: павлоград
памятник: памятник
память: память
панно: панно
панорама: панорама
пантеон: пантеоне
параджанов: параджанов
париж: париж
парнис: парнис
паронянин: паронян
пастух: пастухом
паулсом: паулсом
паустовский: паустовский
пахнуть: пахнет
певица: певица певице
пейзаж: пейзажа
пепуц: пепуца
пер: пер
первый: первую первый
переехать: переехал
переиздаваться: переиздававшаяся
перейти: перейти
перерыв: перерывами
перрон: перроне
персоналия: персоналии
персональный: персональные
перу: перу
песенка: песенка
песня: песне песни песню песня
петербург: петербурге
печать: печати печать
пивной: пивной
пигмент: пигмент
пикассо: пикассо
пир: пира
пирожок: пирожками
пиросма: пиросма
пиросман: пиросман
пиросманашвили: пиросманашвили
пиросманашвить: пиросманашви
пиросманить: пиросмани
пиросманишвили: пиросманишвили
пиросманишвить: пиросманишви
писать: писал писать пишет
питательный: питательной
питейный: питейных
повар: повара
поведение: поведения
поверхность: поверхностью
повествовать: повествует
повесть: повести повесть
повлиять: повлиял
поворот: повороте
повторяться: повторяющимся
подвал: подвалах подвале
подмешивать: подмешивал
подробный: подробнее подробное
подтвердить: подтверждены
подтверждение: подтверждений
пожертвовать: пожертвовать
позаботиться: позаботиться
поиск: поиск поиску
пока: пока
показывать: показывает
покидать: покидал
покупать: покупал
политика: политика
полный: полной
положение: положение
полтора: полтора
полуголодный: полуголодным
полуприцеп: полуприцеп
получить: получил получили получить
поместье: поместье
помнить: помнит
помогать: помогал
помощник: помощником
понемногу: понемногу
попасть: попал
попросить: попросила
популярный: популярен популярная популярный
портрет: портрет портретов портретом портреты
посвятить: посвятили посвящённая
последний: последней последние последний
пособие: пособие
постановка: постановке
постановщик: постановщик
постоянно: постоянно
постоянный: постоянная
постояной: постояную
поступить: поступил
похожий: похожи
похоронить: похороненные
почва: почвой
почтовый: почтовая
поэзия: поэзии
поэт: поэт поэты
поэтический: поэтическое
правило: правило
править: править
правка: правки правок
праздник: праздника
предмет: предметом
предположительно: предположительно
представитель: представитель представителями
представиться: представились
представлять: представляют
премьера: премьера
привезти: привезённых
пригласить: пригласить
придавать: придавал
придаваться: придавалось
примерно: примерно
примечание: примечания
примитивизм: примитивизм примитивизма
примитивист: примитивиста примитивисты
приобрести: приобрёл
присвоить: присвоено
присутствовать: присутствуют
причём: причём
проверить: проверенной
проверка: проверки
проверяться: проверялась
провести: провёл
прогулка: прогулка
продавец: продавец
проект: проектах
проживание: проживание
проза: проза
прозвище: прозвища
произведение: произведений произведения произведениями
пройти: прошла
прообраз: прообразы
пропагандировать: пропагандировать
прославить: прославлена
просмотр: просмотры
просто: просто
простой: простой простых
пространство: пространства
прочее: прочее
проявить: проявил
психически: психически
псковитин: псковитинов
публика: публика
пугачёв: пугачёвой
пупырчатый: пупырчатой
пшавел: пшавела пшавелы
пытаться: пытался
пьеса: пьеса пьесе
пятнадцать: пятнадцати
пятница: пятниц
пять: пяти
р: р
работа: работ работу работы
работать: работал
работодательница: работодательницы
различный: различные
разлука: разлук
разместить: размещён
разработчик: разработчики
раймонд: раймондом
район: районе
рано: рано
расписывать: расписывавших
рассказ: рассказов
расти: рос
реальный: реальные
ребёнок: детьми ребёнок
реверс: реверсе
ред: ред
режиссёр: режиссёр режиссёры
ремесло: ремеслу
репертуар: репертуаре
ресурс: ресурсы
речь: речь
решить: решено решил
римма: римма
рисование: рисовании
рнб: рнб
родина: родине
родиться: род родившиеся родился
родственник: родственникам
рождение: рождении рождения
роза: роз
роль: роли роль
роспись: росписи
российский: российская российский российским российской
ру: ру
рубашка: рубашке
рубль: рублей рублю
рука: рукой
русски: русски
русский: русская русские русский русском
русый: рус
рыбак: рыбак
рыбчинский: рыбчинского
ряд: ряд ряде
рёв: ревы
сайт: сайты
сам: сама самого самом
самиздат: самиздат
самородок: самородок
самостоятельный: самостоятельного
самоучка: самоучка самоучки
самоучкой: самоучкой
саникидзе: саникидзе
санкт: санкт
сарабьянов: сарабьяновым
сведение: сведения
свежий: свежие
свободный: свободной
свой: свои
свойство: свойство
свыше: свыше
связанный: связанные
связаться: свяжитесь
святой: святых
севр: севр
село: селе
семь: семь
семья: семье семьи
сентябрь: сентября
сера: сер
сергей: сергей
сердце: сердце
середина: середине
серия: серии
сестра: сестра сестре сестру сёстры
сигнахи: сигнахи
сигнахский: сигнахского
сидеть: сижу
сие: сего
симфония: симфония
система: системе
систематический: систематического
сказаться: сказалось
скала: скал
скачать: скачать
сколько: сколько
скончаться: скончался
скрытый: скрытые
скульптор: скульптор
слишком: слишком
словарь: словари
слово: слов слова
служебный: служебные
случай: случаях
случайный: случайная
смеляков: смеляков
смерть: смерти смерть смертью
смотреть: см
сначала: сначала
снедь: снедью
снятой: снятой
снять: сняты
собака: собака
собирать: собирать
собрание: собранием собраниях
собственный: собственному собственные
событие: события
совершенно: совершенно
современный: современного
содержание: содержание
создавать: создавать создавая
создать: созданное создать
солнце: солнце
сообщество: сообщество
сообщить: сообщить
составлять: составляют
состояние: состоянии
состояться: состоялась
сохранение: сохранением
сохраниться: сохранившимся сохранившихся
спб: спб
спектакль: спектакль
специально: специально
специальный: специальной
список: список
справка: справка
среди: среди
средство: средства
српски: српски
ссср: ссср
ссылка: ссылка ссылки
становиться: становились
старший: старший
старый: старая
статистика: статистика
стать: ставшая стал стала
статья: статьи статью статья
стиль: стиль
стих: стихи
сто: сто
стоить: стоила
стол: столы
столик: столика
столько: столько
сторона: стороне
страна: стран
страница: страница странице страницу страницы
странствовать: странствующих
стригалёв: стригалёв
сулхан: сулхана
суперобл: суперобл
суперпопулярный: суперпопулярной
сухой: сухой
существенный: существенной существенную
существование: существованием
существовать: существует существуют
сцена: сцены
сценарий: сценарий
сценограф: сценограф
считаться: считается
сш: сш
сын: сыном
сюда: сюда
сюжет: сюжетом
табидзе: табидзе
так: т
также: также
таковой: таковой
такой: такие такое
тамара: тамара
тбилиси: тбилиси
творчество: творчества творчестве творчество творчеством
театр: театра
текст: текст
текущий: текущая текущие
телеспектакль: телеспектакль
тема: тему
тематический: тематические
теоретик: теоретик
термин: термина
тетереть: тетри
технический: технических
типография: типографии
тифлис: тифлис тифлисе
тифлисский: тифлисская тифлисской
тициан: тициан
товарный: товарный
торговать: торговать
торговля: торговле торговлей торговлю
торговый: торговых
тормозной: тормозным
тот: тех
требовать: требуют
третьяковский: третьяковская третьяковской
три: трёх
уволиться: уволился
углахъ: углахъ
узреть: узрев
уйти: ушёл
указание: указанием
указать: указан
укра: укра
украина: украина украины
украсть: украденное
улица: улице
улучшать: улучшать
умереть: умер умерла
умерший: умершие
упоминаться: упоминается
управляться: управлялся
упражняться: упражнялся
условие: условий условия
успех: успех
утверждение: утверждения
утерять: утерянных
уточнение: уточнения
уход: уход
ухудшиться: ухудшилось
участие: участие
участник: участниками
учиться: учился
учредить: учреждён
учёба: учёбы
учётный: учётную
факт: факты
февраль: февраля
фильм: фильма фильмы
финансовый: финансовом
фон: фон фона фоне
фонд: фонд
форум: форум
фотография: фотографиям
фрагмент: фрагменты
французский: французской
футурист: футуристов футуристы
х: х
характерный: характерен характерной
хеловнебо: хеловнеба
хозяйский: хозяйскую
хозяйство: хозяйству
холст: холста холсте
хорватский: хорватская
храниться: хранится
художественный: художественного
художник: художник художника художнике художники художников художником художнику
цитировать: цитировать
частично: частично
часто: часто
часть: часть частью
человек: людей люди человеку
четверть: четверти
четвёртый: четвёртый
читать: читать
чрезвычайно: чрезвычайно
чёрный: чёрная чёрного чёрной чёрном чёрные чёрный
ша: ша
шар: шаром
шаталов: шаталов
шатский: шатских
шеварднадзе: шеварднадзе
шенгелая: шенгелая
широкий: широкая
школажизнь: школажизни
шулаверь: шулавери
э: э
экз: экз
экспозиция: экспозицию экспозиция
экспорт: экспорт
элгуджа: элгуджа
элемент: элемент
энциклопедия: энциклопедии энциклопедия
эпросина: эпросине
эраст: эраст
это: это
этот: эта этих этому
ю: ю
юрий: юрий
являться: являются
язык: язык языках
якобы: якобы
январь: января
яркий: яркий яркого
ярослав: ярослав
