август: августа
авторство: авторства
агентство: агентства
академия: академии
алфавит: алфавиту
аппликация: аппликация
апрель: апреля
архивировать: архивировано
аспелина: аспелин аспелина
библиографический: библиографических
библиография: библиография
библиотека: библиотека
биография: биография
биргитта: биргитте биргиттой
больница: больница
большой: большой
век: века
версия: версия
вестр: вестра
викидать: викиданных
викимедиа: викимедиа
википедия: википедии википедия
вклад: вклад
внешний: внешние
войти: войти
волшебный: волшебные
выставка: выставку
галерея: галерее
герт: герт
год: год года году
гуннар: гуннар гуннара
гёталанда: гёталанд
гётеборг: гётеборг гётеборге
гётеборгский: гётеборгском
дата: дата
двое: двое
дебютировать: дебютировал
действовать: действовать
декабрь: декабря
деятельность: деятельности
дополнительный: дополнительные
доступный: доступен
другой: других
ещё: ещё
жениться: женился
живопись: живописи
жилищный: жилищного
заглавный: заглавная
зал: зал зале
занятие: занятий
запись: запись
зарегистрировать: зарегистрированный
заявление: заявление
знак: знак
избранный: избранная избранные
изображение: изображений
ильвой: ильвой
имя: имён
инструмент: инструменты
искусство: искусств искусства
использование: использования
использовать: использующие
история: истории история
источник: источник
кальмар: кальмара
карлскруна: карлскруне
карлссон: карлссон
картина: картина
каталог: каталогах
категория: категории
код: код
кодекс: кодекс
конфиденциальность: конфиденциальности
королевский: королевской
короткий: короткий
кристиан: кристиан
кук: куки
кьелльквист: кьелльквист
лицензия: лицензии
мальмё: мальмё
материал: материал
медицина: медицины
место: место
мобильный: мобильная
мочь: могут
музей: музее
мы: нами
навигация: навигации навигация
некоммерческий: некоммерческой
неопр: неопр
новый: новые
норрчёпинг: норрчёпинга
обращение: обращения
обсуждение: обсуждение
общественный: общественные
окружный: окружном
октябрь: октября
описание: описание
организация: организации
осенний: осеннем
ответственность: ответственности
отдельный: отдельных
отец: отец
отказ: отказ
отредактировать: отредактирована
ошибка: ошибке
пара: пары
первый: первую
перейти: перейти
персоналия: персоналии
персональный: персональную персональные
печать: печати печать
писатель: писатель
поведение: поведения
подробный: подробнее
пожертвовать: пожертвовать
поиск: поиск поиску
политика: политика
получить: получить
последний: последний
постоянный: постоянная
править: править
правка: правки
представить: представлен
представиться: представились
примечание: примечания
провести: провёл
проект: проектах
просмотр: просмотры
пространство: пространства
профессор: профессора
путешествие: путешествий
работа: работы
разработчик: разработчики
расширение: расширение
ребёнок: детей
ресурс: ресурсы
родиться: род родившиеся родилось родился
рождение: рождения
русский: русский
салон: салоне
сведение: сведения
свежий: свежие
свободный: свободной свободных
связанный: связанные
связаться: свяжитесь
семья: семье
симрисхамный: симрисхамна
система: системе
сканий: скания
скачать: скачать
скон: сконе
скрытый: скрытые
служебный: служебные
случай: случаях
случайный: случайная
смерть: смерти
смотреть: см
событие: события
совместно: совместно
современный: современного
содержание: содержание
создать: создать
сообщество: сообщество
сообщить: сообщить
сохранение: сохранением
справка: справка
ссылка: ссылка ссылки
статистика: статистика
статья: статьи статья
стокгольм: стокгольме
страна: страна
страница: страница странице страницу страницы
суд: суда суде
сюда: сюда
текст: текст
текстильный: текстильная
текущий: текущие
тип: тип
товарный: товарный
указание: указанием
указать: указан
умерший: умершие
условие: условий условия
участие: участие
учиться: учился
учётный: учётную
февраль: февраля
филип: филипа
философия: философии
фон: фон
фонд: фонд
форум: форум
фреска: фреска
хальмстад: хальмстада
хольм: хольм
художественный: художественном
художник: художник художники
цитировать: цитировать
человек: человек
чивика: чивик
читать: читать
шанец: шанца
швед: швед
шведский: шведский шведского
швеция: швеции швеция
школа: школе
эдвард: эдвард
экспорт: экспорт
элемент: элемент
энциклопедия: энциклопедии
этот: эта
язык: язык языках
