август: августа
авт: авт
автор: автор авторов
авторство: авторства
агафонов: агафонова
академия: академии академия
акварелист: акварелисты
акварель: акварели акварелях
александр: александр
алфавит: алфавиту
альбом: альбом
альма: альм
ампир: ампир
ан: ан
апрель: апреля
артишок: артишок
арх: арха
архангельск: архангельском
архангельский: архангельский архангельского
архангельско: архангельско
археолог: археолог
археологический: археологических
архив: архив архива
архивировать: архивировано
архиерейский: архиерейского
архимандрит: архимандрит
архитектура: архитектуры
архитектурный: архитектурный
б: б
бабушка: бабушка
библиография: библиография
библиотека: библиотека
библиофил: библиофила библиофилов
биография: биография
блохинец: блохинцев
бог: богом
болгарский: болгарский
больший: большая
бонфи: бонфи
борис: борис борису
бороденков: бороденкова
борька: борька
брак: браке
будущее: будущего
быть: е
варфоломеевич: варфоломеевич
василькин: василькин
век: века
вектор: вектор
венец: венцом
венчаться: венчался
верея: верея
версия: версии версия
вести: вёл
весь: весь всей вся
ветер: ветру
вид: виды
викидать: викиданных
викимедиа: викимедиа
википедия: википедии википедия
викисклад: викисклад викискладе
винникнуть: винник
вклад: вклад
возникновение: возникновения
войти: войти
волга: волга волге
волжский: волжским
волшебный: волшебные
вопрос: вопросу
воскресенский: воскресенской
восприемник: восприемниками
время: времена
всероса: всерос
всероссийский: всероссийских
выдающийся: выдающихся
вып: вып
выпуск: выпуск
выпускник: выпускники
высокий: высшем
выставка: выставка выставке выставки выставок
выступать: выступал
вышивка: вышивки
г: г
галерея: галереи
галина: галина
геннадий: геннадий
гимназия: гимназии гимназиях
год: год года годов году годы лет
головин: головина
гольдблат: гольдблата
гончаров: гончарова
гончаровский: гончаровская
город: города городам городах городом
гостипо: гостипо
государственный: государственного государственный
гравюра: гравюр
график: график графиках
графика: графика графике графики
губа: губ
гуманитарный: гуманитарных
гумилевский: гумилевской
давать: давал
далее: д
дар: дар
дата: дат дата
два: две
дворец: дворец
действовать: действовать
день: дня
деревня: деревня
деятельность: деятельности
директор: директор
дми: дми
дмитрий: дмитрий дмитрия
добавить: добавить
довженко: довженко
должность: должность
дом: дома
дополнительный: дополнительные
дорога: дорогой
доска: доска
доступный: доступен
дочь: дочери
др: др
другой: других
дульский: дульский
духовный: духовного духовной духовную
дышать: дышу
егоров: егоров
ещё: ещё
жена: жены
живописец: живописца
живопись: живописи живопись
жизнь: жизни
жить: живу жил
журнал: журнал
жутовский: жутовский жутовского жутовскому
заведение: заведения
заглавный: заглавная
зал: зале
запись: запись
заповедник: заповедник
заполнить: заполнить
зарегистрировать: зарегистрированный
зарубеж: зарубеж
захолустье: захолустье
заявление: заявление
звание: звание звания
здание: здании
земляк: земляки
знак: знак
знаменательный: знаменательных
значительно: значительно
значительный: значительны
ива: ива
иванович: иванович ивановича
из: изо
избранный: избранные
известный: известные
изд: изд
издание: издание
издать: издан
изображение: изображениями
изобраз: изобраз
изобразительный: изобразительное
изоматериал: изоматериал
ил: ил
империя: империи
имя: имени имя имён
индекс: индекс
институт: институт
инструмент: инструменты
искусство: искусства искусство
искусствовед: искусствовед
использование: использования
использовать: использующие
историко: историко
исторический: исторический
история: истории история
источник: источник
истый: ист
июль: июля
июнь: июня
ка: ка
казань: казани казань
календарь: календарь
калужский: калужской
картинный: картинной
каталог: каталог
категория: категории
кладбище: кладбище
классический: классической
кн: кн
книга: книга книги
книжный: книжное
код: код
кодекс: кодекс
коллекция: коллекция
колония: колонии
конверт: конверт
конец: конец
конф: конф
конференция: конференции
конфиденциальность: конфиденциальности
корнилов: корнилов
королева: королева
короткий: короткий
корпорация: корпорация
костягин: костягина
котов: котова
который: которых
краевед: краевед краеведа
краеведение: краеведение краеведению
краеведческий: краеведческий
край: края
крестить: крестили
крёстный: крёстными
кук: куки
культура: культуры
культурный: культурной
купить: купить
курс: курсах
л: л
лампадка: лампадка
лектор: лектор
ленин: ленина
ленинский: ленинские
летие: летию
линогравюра: линогравюры
лита: лит
литература: литература
литогра: литогр
литография: литографии
лицензия: лицензии
любитель: любитель
любовь: любви
м: м
магазин: магазин
май: мая
маркированный: маркированный
мастерство: мастерстве
материал: материал материалам материалы
материальный: материальной
медаль: медаль
медиафайл: медиафайлы
международный: международной
мемориал: мемориал
мемориальный: мемориальная
местный: местных
место: места место
министерство: министерством
мир: мир
миронов: миронова
мобильный: мобильная
моном: мономах
москва: москва москве
московский: московских московской
мосха: мосх
мочь: могут
музей: музеи музей музею музея
музый: музо
мы: нами
н: н
навигация: навигации навигация
награда: награды
надежда: надеждой надежды
наиболее: наиболее
наука: наук
научий: науч
научный: научной научный
находиться: находятся
национальный: национальная
начало: начало
начальный: начальном
наш: наши
нгельский: нгельский
некоммерческий: некоммерческой
некоторый: некоторые
неопр: неопр
нераспознанный: нераспознанным
несохранившийся: несохранившихся
ние: ние
николаевич: николаевна
нович: нович
новый: новые
нонна: нонна
носить: носит
ноябрь: ноября
ныне: ныне
обл: обл
областной: областной
область: области область
обнинск: обнинск
обнинский: обнинское
образование: образование
обращение: обращения
обсуждение: обсуждение
объединение: объединения
одновременно: одновременно
озарить: озаренные
окончание: окончания
окончить: окончил
окт: окт
ольга: ольга
описание: описание
определение: определение
опытный: опытными
орг: орг
организация: организации
оставить: оставили
остроградский: остроградский остроградского
отв: отв
ответственность: ответственности
отд: отд
отдельный: отдельных
отечество: отечества
отказ: отказ
отличаться: отличаться
отредактировать: отредактирована
оценка: оценки
очаровать: очарованный
очерк: очерки
ошибка: ошибке
п: п
павлович: павловной павловны
памятник: памятники
память: памяти память
педагог: педагог педагога педагоги
педагогический: педагогических педагогическом
пейзаж: пейзажи
пейзажист: пейзажист пейзажисты
первый: первого первом первый первым
передвижной: передвижная
перейти: перейти
переулок: переулков переулок
персоналия: персоналии
персональный: персональные
перфил: перфилов
петербург: петербурге
петербургский: петербургская
печать: печати печать
писатель: писателя
письмо: письма
пласт: пластов
пластово: пластова
поведение: поведения
поволж: поволж
подать: подал
подбородник: подбородников
подробный: подробнее
пожертвовать: пожертвовать
поиск: поиск поиску
пока: пока
поливановский: поливановских
политика: политика политики
получить: получить
пос: пос
посвятить: посвященной посвященные
посвящий: посвящ
послевоенный: послевоенная
последний: последний
постоянный: постоянная
постройка: постройках
похоронить: похороненные
похоронный: похоронен
почтовый: почтовый
правда: правда
править: править
правка: правки правок
правление: правление
православный: православный
практ: практ
предмет: предмет
предназначение: предназначение
представиться: представились
преподаватель: преподавателя
преподавать: преподавал
прибыловский: прибыловская
приволж: приволж
приволжский: приволжская приволжское
примечание: примечания
приходский: приходской
проверить: проверенной
проверка: проверки
проверяться: проверялась
продвижение: продвижения
проект: проектах
проза: проза
произва: произв
произведение: произведений произведения
прославить: прославившие
просмотр: просмотры
пространство: пространства
прошение: прошение
пузыревский: пузыревского
работа: работ
работать: работал
радуга: радугой
разработчик: разработчики
расти: рос
расширение: расширение
реалия: реалии
ред: ред
ремесло: ремесле
репей: репьев
республика: республика
рисование: рисование рисования
рисунок: рисунках рисунки
родина: родине
родиться: род родившиеся родились родился
родник: родники
родниковский: родниковском
родный: родным
родословная: родословной
рождение: рождения
российский: российская российской
россия: россии россия
рсфср: рсфср
ру: ру
русский: русская русский
русый: рус
рф: рф
саратов: саратов
сб: сб
сведение: сведения
свежий: свежие
свободный: свободной
свой: своей
свойство: свойство
связанный: связанные
связаться: свяжитесь
связь: связи
сдать: сдал
секция: секции
сельский: сельские
семинария: семинарии семинарию
семья: семьи семья
сентябрь: сентября
сердце: сердце
серебряный: серебряная
симбир: симбир
симбирск: симбирск симбирска симбирске симбирском симбирску
симбирский: симбирская симбирского симбирской симбирскую
система: системе
сказка: сказка
скачать: скачать
скрытый: скрытые
слева: слева
след: след
сложа: слож
служебный: служебные
случай: случаях
случайный: случайная
смерть: смерти
смирнов: смирнова
смотреть: см
соб: соб
событие: события
советский: советский
современный: современное
содержание: содержание
создать: создать
сообщество: сообщество
сообщить: сообщить
сост: сост
сохранение: сохранением
союз: союза
спб: спб
список: список
справа: справа
справка: справка
ссср: ссср
ссылка: ссылка ссылки
ст: ст
старина: старина
старое: старого
старый: старая
статистика: статистика
стать: стал стали статей
статья: статьи статья
страна: страна
страница: страница странице страницу страницы
строганов: строганов
студия: студии
сх: сх
сытина: сытина
сюда: сюда
так: т
татарстан: татарстан
татполиграф: татполиграф
татсср: татсср
творчество: творчества
театральный: театральной
текст: текст
текущий: текущая текущие
тео: тео
тескт: тескта
техникум: техникуме
технология: технологий
типо: типо
товарный: товарный
требовать: требуют
трия: трий
указание: указанием
указать: указан
ульян: ульян
ульянов: ульянов
ульяновск: ульяновск ульяновска ульяновске ульяновску
ульяновский: ульяновская ульяновские ульяновский ульяновских ульяновского ульяновской ульяновском ульяновскую
умереть: умер
умерший: умершие
уохма: уохм
упр: упр
урок: уроки
условие: условий условия
установить: установлена
утвердить: утверждён
уфимский: уфимский
участие: участие
участник: участник участниками
учебный: учебные
ученик: ученику
училище: училища училищах училище
учитель: учителей учителем учитель учителя
учительский: учительских
учиться: учился
учёба: учёба
учётный: учётную
факт: факты
фамилия: фамилией фамилии
февраль: февраля
федотия: федотий
феномен: феномен
филателия: филателия
фонд: фонд
форум: форум
фот: фот
фронт: фронте
фёвр: февр
х: х
хмк: хмк
храниться: хранится
худож: худож
художественный: художественного художественное художественной художественном художественный
художество: художеств
художник: художник художника художники художников
цв: цв
центр: центр
церковный: церковно
церковь: церкви
цикл: циклов
цитировать: цитировать
ч: ч
частный: частные
часть: часть
часы: часы
чебоксары: чебоксары
человек: люди людях человек
число: числе
читать: читать
член: член члены
чтение: чтений
чувашский: чувашская чувашский чувашской чувашском
шацкий: шацкого
школа: школах школе школы
щусев: щусева
экзамен: экзамены
эконом: эконом
экскурсионный: экскурсионная
экспедиция: экспедиции
экспорт: экспорт
элемент: элемент
энциклопедия: энциклопедии энциклопедия
этнограф: этнограф этнографа
этот: эта
ю: ю
юбилей: юбилею
язык: язык языках языком
якубович: якубович
январь: января
яценко: яценко
