аветисян: аветисян аветисяна
авторство: авторства
азатович: азатович
активно: активно
алфавит: алфавиту
арест: арест ареста
арестовать: арестован
арма: арм
армен: армен армена
армения: армении армения
армянский: армянский армянском армянскому
ателье: ателье
библиотека: библиотека
биография: биография
благотворительный: благотворительным
больница: больнице
борис: бориса
бухарест: бухарест
ванадзор: ванадзор ванадзоре
ведущий: ведущих
век: века
вернуться: вернулся
версия: версия
взять: взял
викидать: викиданных
викимедиа: викимедиа
википедия: википедии википедия
вклад: вклад
возле: возле
войти: войти
воскресение: воскресения
восстановить: восстановленной
всероссийский: всероссийский
выставка: выставка выставках
выставочный: выставочный
галерея: галерея
год: года году лет
город: города городе
государственный: государственная государственный
гражданство: гражданство
график: график
графика: графики
гребенщиков: гребенщикова
дата: дата
дать: дал
действие: действие
действовать: действовать
декабрь: декабря
деятель: деятеле деятели деятелях
деятельность: деятельности
дизайнер: дизайнеров
дирекция: дирекция
добавить: добавить
додж: додж
дом: дома
дополнительный: дополнительные
дополнить: дополнив
доступный: доступен
другой: других
единственный: единственный
ереван: ереван ереване
ещё: ещё
её: её
живописец: живописец
заглавный: заглавная
заготовка: заготовка
заключить: заключён
закон: закона
закончить: закончив
зал: зал
запись: запись
заполнить: заполнить
зарегистрировать: зарегистрированный
заявление: заявление
знак: знак
избранный: избранные
известный: известные
изображение: изображениями
изобразительный: изобразительного
имя: имя имён
инструмент: инструменты
искусство: искусства искусство
использование: использования
использовать: используемая
история: истории историю история
источник: источник
июль: июля
категория: категории
качество: качестве
квартирный: квартирных
кировакан: кировакан кировакане
кироваканский: кироваканский
кладбище: кладбище
код: код
кодекс: кодекс
коллекция: коллекция коллекциях
конфиденциальность: конфиденциальности
концерт: концерт
короткий: короткий
который: котором который
крепость: крепость
крест: крестах кресты
кук: куки
культура: культуры
ленинград: ленинград ленинграда
ленинградский: ленинградской
лицензия: лицензии
лишь: лишь
лёва: лёва
манеж: манеж
мастер: мастеров
мастерская: мастерская мастерской
материал: материал
международный: международной
место: место
месяц: месяца месяцев
мид: мида
многочисленный: многочисленных
мобильный: мобильная
молодёжь: молодёжи
монжерон: монжерон
мочь: могут
музей: музеев музей
мы: нами
навигация: навигации навигация
назначение: назначению
налог: налогов
народ: народу
наслать: нашли
находиться: находятся
национальный: национальная
незавершённый: незавершённые
неизвестный: неизвестными
некоммерческий: некоммерческой
неофициальный: неофициального неофициальное
неуплата: неуплате неуплату
новый: новые
нонконформистский: нонконформистского
нортон: нортона
ноябрь: ноября
ныне: ныне
нэнси: нэнси
обвинение: обвинение обвинению обвинения
область: области
обсуждение: обсуждение
обучение: обучение
общественный: общественным
объединение: объединения
обыск: обыски
описание: описание
организация: организации
освобождение: освобождения
осудить: осуждён
ответственность: ответственности
отдельный: отдельных
отец: отца
отказ: отказ
отобрать: отобрана
отредактировать: отредактирована
оформитель: оформителя
ошибка: ошибке
параметр: параметрами
переехать: переехал
перейти: перейти
персоналия: персоналии
персональный: персональная персональные
петербург: петербург петербурга петербурге
петербургский: петербургского
петропавловский: петропавловская
печать: печати печать
поведение: поведения
подробный: подробнее
подчеркнуть: подчеркнуть
подыскивать: подыскивать
пожертвовать: пожертвовать
поиск: поиск поиску
политика: политика
получить: получить
помочь: помогите
последний: последний
постоянный: постоянная
похоронить: похороненные
похоронный: похоронен
править: править
правка: правки
представиться: представились
предъявить: предъявлено
принадлежность: принадлежность
провести: провели
проект: проектах
прокурор: прокурор
просмотр: просмотры
пространство: пространства
профессиональный: профессиональный
псевдоним: псевдонимами
публичный: публичная
пушкин: пушкина
работа: работы
работать: работал
работник: работников
разгромить: разгромлена
разработчик: разработчики
родиться: род родившиеся родился
рождение: рождении рождения
российский: российский российского
россия: россии россия
румыния: румыния
русский: русский русского
санкт: санкт
санкция: санкцию
сведение: сведения
свежий: свежие
свободный: свободной
свойство: свойство
связанный: связанные
связаться: свяжитесь
святой: святого
сизый: сизо
система: системе
скачать: скачать
скончаться: скончался
скрытый: скрытые
служебный: служебные
случай: случаях
случайный: случайная
смерть: смерти
смоленск: смоленском
смотреть: см
собрание: собраниях
событие: события
советский: советский
современный: современного
содействие: содействии
содержание: содержание
создать: создать
сообщество: сообщество
сообщить: сообщить
состояться: состоялись состоялся
сотрудничать: сотрудничать
сохранение: сохранением
союз: союз союза
спб: спб
спорт: спорта
справка: справка
ссср: ссср
ссылка: ссылка ссылки
статистика: статистика
стать: стал стали
статья: статьи статью статья
страница: страница странице страницу страницы
суд: суд
супруг: супруга
сша: сша
сюда: сюда
творческий: творческого
текст: текст
текущий: текущие
теургический: теургическое
товарный: товарный
указание: указанием
умерший: умершие
условие: условий условия
участвовать: участвовал
участие: участие
училище: училище
учиться: учился
учётный: учётную
февраль: февраля
федерация: федерации
фонд: фонд фондом
форум: форум
франция: франция
художественный: художественном
художник: художник художника художники художников
центральный: центральный
церковь: церкови
цитировать: цитировать
четыре: четыре
читать: читать
член: член
шаблон: шаблона
экспорт: экспорт
элемент: элемент
элени: элени
энциклопедия: энциклопедии
это: это
этот: эта
язык: языках
