авалишвили: авалишвили
авалишвилль: авалишвилли
авалов: авалова
авторство: авторства
аеа: аеа
айдинянин: айдинян
академия: академии академия
аквариус: аквариус
активно: активно
акция: акция
александров: александров
алиев: алиева
алфавит: алфавиту
алёшин: алешина
ампир: ампир
анастасия: анастасии
андрей: андрей андрея
апрель: апреля
арден: ардена
армения: армении армения
арс: арс
арси: арси
арт: арт
артиндекс: артиндекс
архивировать: архивировано
архивный: архивная
архитектор: архитектора
ассоциация: ассоциации ассоциация
аукцион: аукцион аукционах
базовый: базовые
балтимор: балтимор балтиморе
бальмонт: бальмонт бальмонта
библиография: библиография
библиотека: библиотека
биография: биографии биография
благотворительный: благотворительный
большой: большой
бостон: бостон
буклет: буклет
валентина: валентины
везде: везде
век: века
великобритания: великобритании
вепхвадзе: вепхвадзе
версия: версии версия
весенний: весенние весенний
весь: всей
вече: вече
вечный: вечный
взгляд: взгляд
вика: вики
викидать: викиданных
викимедиа: викимедиа
википедия: википедии википедия
викисклад: викисклад викискладе
винсент: винсент
виртуоз: виртуоза
вклад: вклад
владимир: владимира
вместо: вместо
возможность: возможности
войти: войти
волшебный: волшебные
вопрос: вопрос
восточный: восточного
впервые: впервые
время: времени
вручение: вручение
вручить: вручён
второй: второй
вхутемас: вхутемас
вчера: вчера
выпуск: выпуск
выпускник: выпускники
высоцкий: высоцкого
выставка: выставка выставках выставке выставки выставок
выставочный: выставочного выставочном выставочный
выхино: выхино
г: г
газета: газета
галерея: галерее галереи галерея
гармоничный: гармоничный
гармония: гармония
гейзер: гейзеры
германия: германии
гиви: гиви
год: год года году лет
голландия: голландии
гост: гост
государственный: государственная государственной государственный
гражданство: гражданство
греция: греция
григориевич: григорьевич
григорий: григория
грузинский: грузинская
грузия: грузии грузия
группа: группы
далее: д далее
дальнейший: дальнейшем
дата: дата
дважды: дважды
двести: двухстах
действительный: действительный
действовать: действовать
декабрь: декабря
день: дней
десятый: десятого десятый
детство: детства
деятель: деятель
деятельность: деятельности
джапаридзе: джапаридзе
джованни: джованни
диплом: диплом диплома дипломов
дипломант: дипломанты
дмитриевич: дмитриевич
дмитрий: дмитрий
добролюбов: добролюбова
дойти: дошла
документ: документы
дом: дом
дополнительный: дополнительные
доступный: доступен
дочь: дочь
др: др
другой: других
дружба: дружба
дух: дух
душа: души
дыня: дыни дыня
евангелист: евангелисты
единство: единство
ежемесячный: ежемесячный
елисеевич: елисеевича
ереван: ереван
ещё: ещё
жанр: жанр
живописец: живописец
живопись: живопись
журнал: журнал
журналист: журналиста
завтра: завтра
заглавный: заглавная
зал: зал зала
заместитель: заместитель
зао: зао
западный: западного
запись: запись
заполнить: заполнить
зарегистрировать: зарегистрированный
защита: защиты
заявление: заявление
збекча: збекча
звезда: звезд звезда
зимина: зиминой
знак: знак
значительно: значительно
золотой: золотая золотые золотыми
ивановский: ивановская
избранный: избранные
издательство: издательство
изображение: изображении изображениями
израиль: израиля
ил: ил
иллюстрация: иллюстрации
император: императора
имя: имён
инженер: инженера
инк: инков
инструмент: инструменты
интервью: интервью
интерпретация: интерпретаций
иса: ис
искренность: искренности
искусство: искусств искусства искусстве искусство
использование: использования
использовать: использующие
история: история
источник: источник источники
италия: италия
июнь: июня
июньский: июньский
й: й
карадаг: карадаг
картина: картины
картинный: картинная
карточка: карточки
каталог: каталог каталогах
категория: категории
кецховели: кецховели
кжи: кжи
кипр: кипр кипре
кисть: кисть
класс: класс
классический: классических
клуб: клуба
книга: книге
код: код
кодекс: кодекс
коктебель: коктебель
кокчетавский: кокчетавский
кокшетау: кокшетау
коллекционер: коллекционером
коллекция: коллекции коллекция
колодец: колодец
композиционный: композиционных
композиция: композиций
конкурс: конкурса конкурсов
константин: константин
контекст: контексте
конфиденциальность: конфиденциальности
копия: копия
копьё: копье
корнилов: корнилова корниловым
короткий: короткий
который: которую который которым которых
крепкий: крепкая
крым: крым
кузнецкий: кузнецком
кузьменко: кузьменко
кук: куки
культура: культуры
культурный: культурном культурный
культурологический: культурологический
лауреат: лауреат лауреатом лауреаты
лев: лев
лист: лист листов
литература: литературы
литературно: литературно
лицензия: лицензии
лондон: лондон лондоне
любовь: любви любовью
м: м
мадонна: мадонна
манеж: манеж
марина: марины
март: март
мастер: мастер
материал: материал
медаль: медали медаль медалями
медиафайл: медиафайлы
международный: международная международного международной международный международных
место: место
меценат: меценат меценатом
мир: мир мира
миф: миф
мифология: мифология
михаил: михаил
многий: многих
мобильный: мобильная
модерн: модерн
моисей: моисея
монсегюра: монсегюр
москва: москва москве москву москвы
московский: московский московского московское московской
мост: мостов мосту
мочь: могут
музей: музеев музей музея музеях
музейный: музейных
мы: нами
н: н
навигация: навигации навигация
награда: наград награду награды
наградить: награждён
наложница: наложница
написать: написал
направление: направлению
народ: народов
наука: наука
научно: научно
находиться: находится
национальный: национальная
начало: начале
начать: начал
наш: наших
небо: небо
недавно: недавно
недоступный: недоступная
некоммерческий: некоммерческий некоммерческой
некрасов: некрасова
неопр: неопр
нерабочий: нерабочими
нефертити: нефертити
николай: николаем
никора: никор
новый: новая новые новый
номинант: номинанты
номинация: номинация
ноябрь: ноября
нужно: нужно
обл: обл
обладатель: обладатель
обложк: обложк
обращение: обращения
обсуждение: обсуждение
общественный: общественный
овременной: овременные
одесса: одесса
одесский: одесский
один: одна
окончание: окончания
ольга: ольга
омск: омск
омский: омский
описание: описание
определять: определял
опубликовать: опубликованы
опытный: опытными
организация: организации
орден: ордена
осенний: осенний
осмысление: осмысление
ответственность: ответственности
отделение: отделение
отдельный: отдельных
отказ: отказ
отказаться: отказаться
открытие: открытие
отличаться: отличаться
отнести: отнести
отражение: отражения
отредактировать: отредактирована
официальный: официальный
ошибка: ошибке
павел: павел
париж: париж париже
пейзажист: пейзажисты
первоначально: первоначально
переехать: переехал
перейти: перейти
перечень: перечень
персоналия: персоналии
персональный: персональная персональном персональные
петербург: петербург петербурге
печать: печати печать
пл: пл
поведение: поведения
подеваться: подевалось
подробный: подробнее
подсознание: подсознания
подтверждать: подтверждающие
подход: подход
пожертвовать: пожертвовать
поиск: поиск поиску
пока: пока
политика: политика
получить: получил получить
популярный: популярный
попытка: попытках
портрет: портрета
портретист: портретисты
портретный: портретная
последний: последний
посольство: посольства
посткубистический: посткубистический
постмодернизм: постмодернизма
постоянный: постоянная
построение: построения
почётный: почетный
поэтому: поэтому
правительство: правительстве
править: править
правка: правки правок
председатель: председателя
представитель: представитель
представиться: представились
президиум: президиум
признание: признание
примечание: примечания
принимать: принимал
пробуждение: пробуждение
проверить: проверенной
проверка: проверки
проверяться: проверялась
продажа: продаж продажа
проект: проект проекта проектах
произведение: произведений произведения
пройти: прошел
просмотр: просмотры
пространство: пространства пространство
профессиональный: профессиональных
работа: работ работа работы
развитие: развития
различный: различных
разметка: разметкой
разработчик: разработчики
расширение: расширение
расширяться: расширялись
реализм: реализм реализма
революция: революции
результат: результаты
религия: религия
республика: республики
республиканский: республиканские
рим: рим риме
рисунок: рисунки
ритм: ритм
родиться: род родившиеся родился
рождение: рождения
роскон: роскон
российский: российских российской
россия: россии россия
руль: рулем
русский: русский русских
рэдиссон: рэдиссон
сайт: сайт сайте
салон: салон салона салоне
салонный: салонная
сам: самого
санкт: санкт
сафонкина: сафонкин
сведение: сведения
свежий: свежие
свободный: свободной
свой: своей
свойство: свойства свойство
связанный: связанные
связать: связала
связаться: свяжитесь
сезон: сезон
семеричность: семеричность
семья: семье
семёнов: семеновой семёнова
сентябрь: сентября
сергеевич: сергеевны
серия: серия
сертификат: сертификат
система: системе
сканрусый: сканрус
скачать: скачать
скрытый: скрытые
скульптор: скульпторы
славянский: славянская славянские
след: следам
словенский: словенские
слово: слово
служебный: служебные
случай: случаях
случайный: случайная
смирение: смирение
смотреть: см
собрание: собраний собраниях
событие: события
совершенство: совершенство
совет: совет совета
совинцентр: совинцентр совинцентре
современник: современник современников
современность: современность
современный: современная современные современный современных
согласие: согласие
содержание: содержание
создать: создать
сообщество: сообщество
сообщить: сообщить
сотрудничать: сотрудничал
сотрудничество: сотрудничество
сохранение: сохранением
сохраняться: сохранялись
союз: союз союза
союзный: союзное
список: список
справка: справка
справочник: справочник
сср: сср
ссср: ссср
ссылка: ссылка ссылками ссылки
статистика: статистика
стать: стал стали
статья: статьи статья
стр: стр
страница: страница странице страницу страницы
стресс: стресса
строптивый: строптивой
судьба: судьбы
сша: сша
сюда: сюда
так: т
также: также
тамерлан: тамерлан
татьяна: татьяна
тбилиси: тбилиси
тбилисский: тбилисская тбилисской
творческий: творческий творческого творческой
творчество: творчества творчество
текст: текст
текущий: текущая текущие
товарный: товарный
тоннель: тоннелей
тот: та
традиция: традиции традиция
транзит: транзит
требовать: требуют
третий: третьего
тспха: тспх
тушино: тушино
тыква: тыквы
тысячелетие: тысячелетия
указание: указанием
украина: украина
укрощение: укрощение
ул: ул
условие: условий условия
участие: участие участием
участник: участника участниками участники
учитель: учителями
учить: уча
учёба: учёба
учётный: учётную
фамилия: фамилией
фаэтон: фаэтон
февраль: февраля
ферронить: феррони
фестиваль: фестивалей фестиваль фестиваля
флоренция: флоренция
фонд: фонд фонда фондов
форма: форм
форум: форум
фотограф: фотографы
франция: франции
хаммера: хаммер
хасай: хасая
херувим: херувим
храм: храму
художественный: художественная художественного художественной художественный художественными художественных
художество: художеств
художник: художник художника художники художников художником
цв: цв
цвет: цвет
цветаев: цветаевых
цдрить: цдри
цдх: цдх
центр: центр центра центре
центральный: центральный
церадзе: церадзе
цикл: цикл
цитировать: цитировать
частный: частные
человек: людях
четыре: четырех
читать: читать
член: член члены
шаг: шаги
швейцария: швейцарии
шуя: шуя
щучинск: щучинск
щучинский: щучинский
эзкиз: эзкиз
экспериментировать: экспериментировать
эксперт: эксперт экспертов
экспертный: экспертного
экспо: экспо
экспорт: экспорт
экспоцентр: экспоцентр
экспромт: экспромт
элемент: элемент элементы
энциклопедия: энциклопедии
эристави: эристави
этнографический: этнографический
этот: эта этому
юрий: юрий юрия
язык: языках
январь: января
ярмарка: ярмарка ярмарки
ярославль: ярославль
ярославский: ярославский
